x,y,attempt,log_attempt,made,missed
0,0,2,0.3010299956639812,1,1
1,0,1,0.0,0,1
2,0,7,0.8450980400142568,2,5
3,0,5,0.6989700043360189,1,4
4,0,2,0.3010299956639812,0,2
5,0,7,0.8450980400142568,4,3
6,0,1,0.0,0,1
7,0,1,0.0,0,1
8,0,1,0.0,0,1
9,0,1,0.0,0,1
12,0,1,0.0,1,0
16,0,1,0.0,0,1
17,0,1,0.0,1,0
21,0,1,0.0,0,1
27,0,1,0.0,0,1
32,0,1,0.0,0,1
52,0,1,0.0,0,1
54,0,1,0.0,0,1
68,0,1,0.0,0,1
72,0,1,0.0,1,0
77,0,1,0.0,1,0
78,0,1,0.0,1,0
83,0,1,0.0,1,0
90,0,1,0.0,0,1
92,0,2,0.3010299956639812,1,1
93,0,3,0.47712125471966244,1,2
94,0,6,0.7781512503836436,1,5
95,0,8,0.9030899869919435,4,4
96,0,5,0.6989700043360189,0,5
97,0,3,0.47712125471966244,1,2
98,0,2,0.3010299956639812,2,0
0,1,1,0.0,1,0
1,1,5,0.6989700043360189,0,5
2,1,8,0.9030899869919435,5,3
3,1,10,1.0,3,7
4,1,4,0.6020599913279624,0,4
5,1,2,0.3010299956639812,1,1
6,1,1,0.0,0,1
8,1,1,0.0,0,1
10,1,1,0.0,0,1
11,1,1,0.0,0,1
31,1,1,0.0,0,1
49,1,1,0.0,0,1
75,1,1,0.0,0,1
76,1,1,0.0,0,1
77,1,1,0.0,1,0
80,1,1,0.0,0,1
82,1,1,0.0,0,1
84,1,2,0.3010299956639812,1,1
92,1,7,0.8450980400142568,2,5
93,1,2,0.3010299956639812,0,2
94,1,11,1.0413926851582251,2,9
95,1,4,0.6020599913279624,1,3
96,1,4,0.6020599913279624,1,3
97,1,8,0.9030899869919435,3,5
98,1,3,0.47712125471966244,1,2
99,1,2,0.3010299956639812,1,1
0,2,10,1.0,3,7
1,2,5,0.6989700043360189,2,3
2,2,35,1.5440680443502757,12,23
3,2,31,1.4913616938342726,14,17
4,2,18,1.255272505103306,6,12
5,2,11,1.0413926851582251,4,7
7,2,2,0.3010299956639812,1,1
8,2,2,0.3010299956639812,1,1
12,2,1,0.0,0,1
13,2,2,0.3010299956639812,2,0
16,2,1,0.0,0,1
17,2,1,0.0,0,1
23,2,1,0.0,1,0
24,2,2,0.3010299956639812,0,2
28,2,1,0.0,0,1
30,2,2,0.3010299956639812,0,2
31,2,1,0.0,0,1
35,2,1,0.0,0,1
44,2,1,0.0,0,1
45,2,1,0.0,1,0
48,2,1,0.0,1,0
51,2,2,0.3010299956639812,0,2
53,2,1,0.0,0,1
56,2,1,0.0,0,1
63,2,1,0.0,0,1
68,2,1,0.0,0,1
71,2,2,0.3010299956639812,1,1
72,2,1,0.0,1,0
74,2,3,0.47712125471966244,0,3
77,2,3,0.47712125471966244,0,3
78,2,1,0.0,0,1
80,2,1,0.0,0,1
83,2,2,0.3010299956639812,1,1
84,2,3,0.47712125471966244,1,2
87,2,2,0.3010299956639812,1,1
88,2,1,0.0,1,0
89,2,3,0.47712125471966244,0,3
90,2,3,0.47712125471966244,1,2
91,2,2,0.3010299956639812,1,1
92,2,16,1.2041199826559248,4,12
93,2,14,1.146128035678238,6,8
94,2,25,1.3979400086720377,8,17
95,2,27,1.4313637641589874,12,15
96,2,23,1.3617278360175928,7,16
97,2,20,1.3010299956639813,4,16
98,2,4,0.6020599913279624,2,2
99,2,10,1.0,8,2
0,3,15,1.1760912590556813,9,6
1,3,9,0.9542425094393249,2,7
2,3,34,1.5314789170422551,12,22
3,3,36,1.5563025007672873,16,20
4,3,13,1.1139433523068367,2,11
5,3,15,1.1760912590556813,5,10
6,3,2,0.3010299956639812,2,0
8,3,1,0.0,1,0
10,3,4,0.6020599913279624,2,2
13,3,1,0.0,0,1
19,3,2,0.3010299956639812,0,2
20,3,2,0.3010299956639812,0,2
21,3,2,0.3010299956639812,1,1
23,3,1,0.0,1,0
24,3,1,0.0,1,0
27,3,1,0.0,0,1
29,3,1,0.0,1,0
31,3,1,0.0,0,1
32,3,1,0.0,0,1
33,3,3,0.47712125471966244,0,3
35,3,2,0.3010299956639812,1,1
60,3,1,0.0,0,1
63,3,1,0.0,0,1
64,3,1,0.0,0,1
67,3,2,0.3010299956639812,0,2
69,3,2,0.3010299956639812,1,1
73,3,2,0.3010299956639812,0,2
74,3,1,0.0,0,1
76,3,2,0.3010299956639812,0,2
78,3,1,0.0,1,0
80,3,1,0.0,1,0
87,3,1,0.0,0,1
89,3,1,0.0,1,0
90,3,3,0.47712125471966244,0,3
91,3,3,0.47712125471966244,1,2
92,3,17,1.2304489213782739,6,11
93,3,11,1.0413926851582251,3,8
94,3,21,1.3222192947339193,6,15
95,3,31,1.4913616938342726,13,18
96,3,17,1.2304489213782739,6,11
97,3,21,1.3222192947339193,9,12
98,3,7,0.8450980400142568,1,6
99,3,8,0.9030899869919435,3,5
0,4,22,1.3424226808222062,6,16
1,4,25,1.3979400086720377,9,16
2,4,63,1.7993405494535817,15,48
3,4,71,1.8512583487190752,19,52
4,4,59,1.7708520116421442,17,42
5,4,39,1.591064607026499,9,30
6,4,2,0.3010299956639812,0,2
7,4,2,0.3010299956639812,0,2
8,4,2,0.3010299956639812,1,1
9,4,2,0.3010299956639812,1,1
10,4,3,0.47712125471966244,2,1
13,4,5,0.6989700043360189,2,3
14,4,2,0.3010299956639812,1,1
15,4,4,0.6020599913279624,2,2
17,4,3,0.47712125471966244,1,2
18,4,1,0.0,0,1
19,4,3,0.47712125471966244,1,2
20,4,2,0.3010299956639812,0,2
21,4,1,0.0,1,0
22,4,3,0.47712125471966244,0,3
23,4,3,0.47712125471966244,2,1
24,4,3,0.47712125471966244,2,1
25,4,4,0.6020599913279624,2,2
28,4,2,0.3010299956639812,1,1
29,4,2,0.3010299956639812,1,1
30,4,1,0.0,0,1
31,4,2,0.3010299956639812,2,0
32,4,3,0.47712125471966244,1,2
33,4,3,0.47712125471966244,1,2
34,4,2,0.3010299956639812,2,0
35,4,1,0.0,1,0
38,4,1,0.0,0,1
39,4,1,0.0,0,1
40,4,1,0.0,0,1
41,4,2,0.3010299956639812,1,1
42,4,5,0.6989700043360189,1,4
43,4,4,0.6020599913279624,2,2
44,4,4,0.6020599913279624,1,3
45,4,4,0.6020599913279624,1,3
46,4,2,0.3010299956639812,1,1
47,4,1,0.0,1,0
48,4,1,0.0,1,0
49,4,3,0.47712125471966244,1,2
50,4,2,0.3010299956639812,2,0
51,4,1,0.0,1,0
52,4,2,0.3010299956639812,1,1
53,4,2,0.3010299956639812,2,0
54,4,5,0.6989700043360189,3,2
55,4,7,0.8450980400142568,3,4
56,4,3,0.47712125471966244,1,2
57,4,5,0.6989700043360189,3,2
58,4,1,0.0,0,1
59,4,3,0.47712125471966244,2,1
60,4,1,0.0,0,1
61,4,1,0.0,1,0
62,4,1,0.0,0,1
64,4,4,0.6020599913279624,0,4
65,4,1,0.0,1,0
66,4,2,0.3010299956639812,0,2
67,4,8,0.9030899869919435,2,6
68,4,3,0.47712125471966244,1,2
69,4,4,0.6020599913279624,0,4
71,4,1,0.0,1,0
72,4,3,0.47712125471966244,1,2
73,4,2,0.3010299956639812,2,0
74,4,1,0.0,0,1
75,4,1,0.0,0,1
76,4,2,0.3010299956639812,2,0
78,4,3,0.47712125471966244,3,0
79,4,1,0.0,1,0
80,4,1,0.0,0,1
82,4,2,0.3010299956639812,0,2
83,4,2,0.3010299956639812,0,2
85,4,2,0.3010299956639812,0,2
86,4,1,0.0,1,0
87,4,1,0.0,1,0
88,4,1,0.0,1,0
89,4,3,0.47712125471966244,1,2
90,4,3,0.47712125471966244,3,0
91,4,4,0.6020599913279624,2,2
92,4,39,1.591064607026499,14,25
93,4,35,1.5440680443502757,14,21
94,4,48,1.6812412373755872,19,29
95,4,47,1.6720978579357175,16,31
96,4,34,1.5314789170422551,9,25
97,4,36,1.5563025007672873,11,25
98,4,15,1.1760912590556813,4,11
99,4,13,1.1139433523068367,4,9
0,5,22,1.3424226808222062,6,16
1,5,21,1.3222192947339193,7,14
2,5,50,1.6989700043360187,19,31
3,5,57,1.7558748556724915,21,36
4,5,37,1.568201724066995,12,25
5,5,56,1.7481880270062005,23,33
6,5,3,0.47712125471966244,1,2
7,5,3,0.47712125471966244,1,2
8,5,4,0.6020599913279624,1,3
9,5,1,0.0,0,1
11,5,2,0.3010299956639812,1,1
14,5,2,0.3010299956639812,0,2
16,5,1,0.0,1,0
17,5,1,0.0,0,1
18,5,2,0.3010299956639812,0,2
21,5,5,0.6989700043360189,1,4
22,5,1,0.0,0,1
23,5,2,0.3010299956639812,1,1
24,5,1,0.0,1,0
25,5,3,0.47712125471966244,0,3
26,5,1,0.0,1,0
27,5,4,0.6020599913279624,1,3
28,5,2,0.3010299956639812,0,2
29,5,3,0.47712125471966244,0,3
30,5,3,0.47712125471966244,0,3
31,5,3,0.47712125471966244,0,3
32,5,3,0.47712125471966244,0,3
33,5,4,0.6020599913279624,0,4
34,5,1,0.0,0,1
35,5,1,0.0,0,1
37,5,3,0.47712125471966244,0,3
38,5,1,0.0,1,0
39,5,1,0.0,0,1
40,5,4,0.6020599913279624,4,0
41,5,2,0.3010299956639812,2,0
42,5,3,0.47712125471966244,0,3
43,5,6,0.7781512503836436,2,4
44,5,6,0.7781512503836436,2,4
45,5,5,0.6989700043360189,2,3
46,5,2,0.3010299956639812,1,1
47,5,5,0.6989700043360189,4,1
48,5,1,0.0,0,1
50,5,2,0.3010299956639812,2,0
51,5,4,0.6020599913279624,4,0
52,5,1,0.0,0,1
53,5,6,0.7781512503836436,4,2
54,5,5,0.6989700043360189,2,3
55,5,6,0.7781512503836436,3,3
56,5,5,0.6989700043360189,5,0
57,5,4,0.6020599913279624,2,2
58,5,2,0.3010299956639812,1,1
59,5,3,0.47712125471966244,2,1
60,5,1,0.0,1,0
62,5,1,0.0,1,0
63,5,1,0.0,0,1
64,5,1,0.0,0,1
65,5,3,0.47712125471966244,0,3
66,5,2,0.3010299956639812,0,2
67,5,3,0.47712125471966244,2,1
68,5,4,0.6020599913279624,2,2
69,5,2,0.3010299956639812,2,0
70,5,1,0.0,1,0
71,5,3,0.47712125471966244,0,3
72,5,1,0.0,1,0
73,5,2,0.3010299956639812,1,1
74,5,4,0.6020599913279624,2,2
75,5,1,0.0,1,0
76,5,2,0.3010299956639812,0,2
77,5,3,0.47712125471966244,1,2
78,5,2,0.3010299956639812,0,2
79,5,2,0.3010299956639812,1,1
80,5,1,0.0,0,1
82,5,3,0.47712125471966244,2,1
83,5,2,0.3010299956639812,0,2
84,5,1,0.0,1,0
85,5,4,0.6020599913279624,2,2
86,5,1,0.0,0,1
87,5,2,0.3010299956639812,1,1
88,5,1,0.0,0,1
89,5,3,0.47712125471966244,0,3
90,5,2,0.3010299956639812,1,1
91,5,2,0.3010299956639812,2,0
92,5,31,1.4913616938342726,10,21
93,5,41,1.6127838567197355,17,24
94,5,54,1.7323937598229686,17,37
95,5,61,1.7853298350107671,25,36
96,5,36,1.5563025007672873,17,19
97,5,33,1.5185139398778875,11,22
98,5,13,1.1139433523068367,5,8
99,5,16,1.2041199826559248,8,8
0,6,26,1.414973347970818,10,16
1,6,31,1.4913616938342726,6,25
2,6,93,1.968482948553935,32,61
3,6,105,2.0211892990699383,50,55
4,6,49,1.6901960800285136,17,32
5,6,62,1.792391689498254,24,38
6,6,5,0.6989700043360189,1,4
7,6,3,0.47712125471966244,1,2
8,6,3,0.47712125471966244,1,2
9,6,5,0.6989700043360189,1,4
10,6,7,0.8450980400142568,0,7
11,6,5,0.6989700043360189,4,1
12,6,7,0.8450980400142568,4,3
13,6,4,0.6020599913279624,2,2
14,6,9,0.9542425094393249,4,5
15,6,5,0.6989700043360189,2,3
16,6,3,0.47712125471966244,1,2
17,6,5,0.6989700043360189,1,4
18,6,6,0.7781512503836436,3,3
19,6,4,0.6020599913279624,2,2
20,6,8,0.9030899869919435,0,8
21,6,5,0.6989700043360189,2,3
22,6,6,0.7781512503836436,2,4
23,6,7,0.8450980400142568,1,6
24,6,7,0.8450980400142568,0,7
25,6,9,0.9542425094393249,3,6
26,6,6,0.7781512503836436,0,6
27,6,2,0.3010299956639812,1,1
28,6,5,0.6989700043360189,1,4
29,6,4,0.6020599913279624,2,2
30,6,9,0.9542425094393249,4,5
31,6,7,0.8450980400142568,1,6
32,6,10,1.0,7,3
33,6,8,0.9030899869919435,2,6
34,6,12,1.0791812460476249,3,9
35,6,4,0.6020599913279624,2,2
36,6,5,0.6989700043360189,3,2
37,6,5,0.6989700043360189,2,3
38,6,11,1.0413926851582251,5,6
39,6,7,0.8450980400142568,2,5
40,6,26,1.414973347970818,12,14
41,6,32,1.505149978319906,12,20
42,6,72,1.8573324964312685,50,22
43,6,89,1.9493900066449128,56,33
44,6,142,2.1522883443830563,98,44
45,6,134,2.1271047983648077,80,54
46,6,70,1.845098040014257,52,18
47,6,85,1.9294189257142926,68,17
48,6,1241,3.09377178149873,905,336
49,6,1237,3.0923696996291206,898,339
50,6,1207,3.081707270097349,887,320
51,6,1212,3.0835026198302673,882,330
52,6,67,1.8260748027008264,53,14
53,6,85,1.9294189257142926,66,19
54,6,116,2.0644579892269186,78,38
55,6,136,2.1335389083702174,86,50
56,6,62,1.792391689498254,34,28
57,6,78,1.8920946026904804,48,30
58,6,22,1.3424226808222062,7,15
59,6,29,1.462397997898956,16,13
60,6,9,0.9542425094393249,5,4
61,6,12,1.0791812460476249,6,6
62,6,9,0.9542425094393249,3,6
63,6,7,0.8450980400142568,2,5
64,6,6,0.7781512503836436,3,3
65,6,7,0.8450980400142568,2,5
66,6,8,0.9030899869919435,0,8
67,6,15,1.1760912590556813,4,11
68,6,6,0.7781512503836436,2,4
69,6,8,0.9030899869919435,2,6
70,6,11,1.0413926851582251,3,8
71,6,7,0.8450980400142568,2,5
72,6,10,1.0,4,6
73,6,4,0.6020599913279624,1,3
74,6,8,0.9030899869919435,1,7
75,6,4,0.6020599913279624,1,3
76,6,5,0.6989700043360189,0,5
77,6,5,0.6989700043360189,2,3
78,6,6,0.7781512503836436,2,4
79,6,10,1.0,2,8
80,6,2,0.3010299956639812,0,2
81,6,7,0.8450980400142568,4,3
82,6,4,0.6020599913279624,1,3
83,6,7,0.8450980400142568,3,4
84,6,3,0.47712125471966244,0,3
85,6,2,0.3010299956639812,1,1
86,6,7,0.8450980400142568,4,3
87,6,1,0.0,1,0
88,6,3,0.47712125471966244,1,2
89,6,2,0.3010299956639812,1,1
90,6,4,0.6020599913279624,2,2
91,6,4,0.6020599913279624,1,3
92,6,56,1.7481880270062005,16,40
93,6,49,1.6901960800285136,14,35
94,6,75,1.8750612633917,26,49
95,6,71,1.8512583487190752,27,44
96,6,47,1.6720978579357175,18,29
97,6,54,1.7323937598229686,18,36
98,6,21,1.3222192947339193,8,13
99,6,18,1.255272505103306,7,11
0,7,22,1.3424226808222062,10,12
1,7,31,1.4913616938342726,10,21
2,7,107,2.0293837776852097,38,69
3,7,103,2.012837224705172,39,64
4,7,56,1.7481880270062005,21,35
5,7,65,1.8129133566428555,27,38
6,7,3,0.47712125471966244,1,2
7,7,4,0.6020599913279624,2,2
8,7,6,0.7781512503836436,3,3
9,7,4,0.6020599913279624,2,2
10,7,4,0.6020599913279624,0,4
11,7,2,0.3010299956639812,0,2
12,7,5,0.6989700043360189,1,4
13,7,6,0.7781512503836436,2,4
14,7,5,0.6989700043360189,1,4
15,7,8,0.9030899869919435,6,2
16,7,3,0.47712125471966244,0,3
17,7,4,0.6020599913279624,1,3
18,7,4,0.6020599913279624,2,2
19,7,4,0.6020599913279624,0,4
20,7,6,0.7781512503836436,4,2
21,7,8,0.9030899869919435,1,7
22,7,7,0.8450980400142568,0,7
23,7,3,0.47712125471966244,0,3
24,7,6,0.7781512503836436,1,5
25,7,13,1.1139433523068367,4,9
26,7,7,0.8450980400142568,1,6
27,7,5,0.6989700043360189,1,4
28,7,12,1.0791812460476249,3,9
29,7,5,0.6989700043360189,2,3
30,7,3,0.47712125471966244,0,3
31,7,8,0.9030899869919435,1,7
32,7,8,0.9030899869919435,4,4
33,7,8,0.9030899869919435,4,4
34,7,12,1.0791812460476249,5,7
35,7,9,0.9542425094393249,2,7
36,7,12,1.0791812460476249,7,5
37,7,7,0.8450980400142568,1,6
38,7,3,0.47712125471966244,0,3
39,7,6,0.7781512503836436,0,6
40,7,29,1.462397997898956,16,13
41,7,27,1.4313637641589874,9,18
42,7,70,1.845098040014257,41,29
43,7,122,2.0863598306747484,68,54
44,7,142,2.1522883443830563,102,40
45,7,139,2.143014800254095,113,26
46,7,97,1.9867717342662448,73,24
47,7,91,1.9590413923210936,58,33
48,7,1210,3.0827853703164503,897,313
49,7,1158,3.0637085593914173,868,290
50,7,1244,3.0948203803548,919,325
51,7,1251,3.09725730969342,913,338
52,7,86,1.9344984512435677,59,27
53,7,84,1.9242792860618816,57,27
54,7,116,2.0644579892269186,79,37
55,7,132,2.12057393120585,80,52
56,7,90,1.954242509439325,49,41
57,7,85,1.9294189257142926,51,34
58,7,35,1.5440680443502757,16,19
59,7,32,1.505149978319906,15,17
60,7,14,1.146128035678238,6,8
61,7,9,0.9542425094393249,3,6
62,7,7,0.8450980400142568,4,3
63,7,7,0.8450980400142568,3,4
64,7,4,0.6020599913279624,2,2
65,7,12,1.0791812460476249,1,11
66,7,10,1.0,4,6
67,7,5,0.6989700043360189,2,3
68,7,6,0.7781512503836436,1,5
69,7,4,0.6020599913279624,1,3
70,7,5,0.6989700043360189,2,3
71,7,9,0.9542425094393249,2,7
72,7,9,0.9542425094393249,4,5
73,7,2,0.3010299956639812,0,2
74,7,10,1.0,2,8
75,7,13,1.1139433523068367,5,8
76,7,8,0.9030899869919435,3,5
77,7,7,0.8450980400142568,2,5
78,7,6,0.7781512503836436,1,5
79,7,4,0.6020599913279624,2,2
80,7,1,0.0,1,0
81,7,8,0.9030899869919435,2,6
82,7,1,0.0,1,0
83,7,3,0.47712125471966244,1,2
84,7,4,0.6020599913279624,2,2
85,7,7,0.8450980400142568,3,4
86,7,5,0.6989700043360189,2,3
87,7,3,0.47712125471966244,1,2
88,7,2,0.3010299956639812,0,2
89,7,5,0.6989700043360189,2,3
90,7,1,0.0,0,1
91,7,4,0.6020599913279624,2,2
92,7,41,1.6127838567197355,13,28
93,7,44,1.6434526764861874,15,29
94,7,83,1.919078092376074,32,51
95,7,86,1.9344984512435677,33,53
96,7,46,1.662757831681574,15,31
97,7,52,1.7160033436347992,18,34
98,7,23,1.3617278360175928,7,16
99,7,19,1.2787536009528289,7,12
0,8,36,1.5563025007672873,14,22
1,8,29,1.462397997898956,12,17
2,8,104,2.0170333392987803,38,66
3,8,95,1.9777236052888478,35,60
4,8,80,1.9030899869919435,32,48
5,8,65,1.8129133566428555,19,46
6,8,6,0.7781512503836436,2,4
7,8,4,0.6020599913279624,2,2
8,8,4,0.6020599913279624,1,3
9,8,7,0.8450980400142568,3,4
10,8,1,0.0,0,1
11,8,8,0.9030899869919435,3,5
12,8,9,0.9542425094393249,4,5
13,8,6,0.7781512503836436,1,5
14,8,9,0.9542425094393249,2,7
15,8,4,0.6020599913279624,2,2
16,8,5,0.6989700043360189,2,3
17,8,9,0.9542425094393249,3,6
18,8,4,0.6020599913279624,0,4
19,8,10,1.0,4,6
20,8,9,0.9542425094393249,3,6
21,8,7,0.8450980400142568,1,6
22,8,3,0.47712125471966244,0,3
23,8,12,1.0791812460476249,3,9
24,8,14,1.146128035678238,3,11
25,8,8,0.9030899869919435,3,5
26,8,9,0.9542425094393249,5,4
27,8,15,1.1760912590556813,3,12
28,8,9,0.9542425094393249,4,5
29,8,9,0.9542425094393249,3,6
30,8,17,1.2304489213782739,6,11
31,8,13,1.1139433523068367,4,9
32,8,24,1.380211241711606,7,17
33,8,17,1.2304489213782739,4,13
34,8,21,1.3222192947339193,9,12
35,8,26,1.414973347970818,8,18
36,8,11,1.0413926851582251,5,6
37,8,18,1.255272505103306,5,13
38,8,30,1.4771212547196624,13,17
39,8,20,1.3010299956639813,9,11
40,8,61,1.7853298350107671,23,38
41,8,81,1.9084850188786497,32,49
42,8,226,2.3541084391474008,121,105
43,8,246,2.3909351071033793,134,112
44,8,358,2.5538830266438746,221,137
45,8,362,2.558708570533166,230,132
46,8,263,2.419955748489758,188,75
47,8,250,2.3979400086720375,183,67
48,8,1399,3.1458177144918276,995,404
49,8,1348,3.129689892199301,1005,343
50,8,1409,3.1489109931093564,1032,377
51,8,1412,3.149834696715785,1048,364
52,8,255,2.406540180433955,186,69
53,8,242,2.383815365980431,166,76
54,8,325,2.5118833609788744,199,126
55,8,348,2.5415792439465807,223,125
56,8,252,2.401400540781544,137,115
57,8,235,2.3710678622717363,131,104
58,8,61,1.7853298350107671,29,32
59,8,66,1.8195439355418688,24,42
60,8,14,1.146128035678238,8,6
61,8,27,1.4313637641589874,12,15
62,8,16,1.2041199826559248,2,14
63,8,13,1.1139433523068367,4,9
64,8,15,1.1760912590556813,7,8
65,8,9,0.9542425094393249,3,6
66,8,14,1.146128035678238,8,6
67,8,10,1.0,2,8
68,8,8,0.9030899869919435,2,6
69,8,10,1.0,4,6
70,8,11,1.0413926851582251,5,6
71,8,9,0.9542425094393249,3,6
72,8,5,0.6989700043360189,1,4
73,8,6,0.7781512503836436,4,2
74,8,9,0.9542425094393249,3,6
75,8,7,0.8450980400142568,1,6
76,8,10,1.0,5,5
77,8,11,1.0413926851582251,3,8
78,8,10,1.0,6,4
79,8,14,1.146128035678238,6,8
80,8,3,0.47712125471966244,1,2
81,8,7,0.8450980400142568,4,3
82,8,10,1.0,5,5
83,8,4,0.6020599913279624,1,3
84,8,6,0.7781512503836436,1,5
85,8,6,0.7781512503836436,2,4
86,8,6,0.7781512503836436,3,3
87,8,5,0.6989700043360189,3,2
88,8,2,0.3010299956639812,1,1
89,8,5,0.6989700043360189,0,5
90,8,4,0.6020599913279624,3,1
91,8,6,0.7781512503836436,1,5
92,8,62,1.792391689498254,19,43
93,8,62,1.792391689498254,20,42
94,8,71,1.8512583487190752,28,43
95,8,61,1.7853298350107671,25,36
96,8,57,1.7558748556724915,24,33
97,8,40,1.6020599913279623,12,28
98,8,26,1.414973347970818,7,19
99,8,18,1.255272505103306,6,12
0,9,44,1.6434526764861874,12,32
1,9,41,1.6127838567197355,15,26
2,9,116,2.0644579892269186,47,69
3,9,87,1.9395192526186185,32,55
4,9,72,1.8573324964312685,17,55
5,9,69,1.8388490907372552,20,49
6,9,3,0.47712125471966244,2,1
7,9,7,0.8450980400142568,2,5
8,9,5,0.6989700043360189,1,4
9,9,6,0.7781512503836436,5,1
10,9,5,0.6989700043360189,0,5
11,9,3,0.47712125471966244,2,1
12,9,4,0.6020599913279624,1,3
13,9,8,0.9030899869919435,4,4
14,9,5,0.6989700043360189,3,2
15,9,4,0.6020599913279624,0,4
16,9,14,1.146128035678238,6,8
17,9,8,0.9030899869919435,3,5
18,9,9,0.9542425094393249,2,7
19,9,7,0.8450980400142568,1,6
20,9,8,0.9030899869919435,3,5
21,9,9,0.9542425094393249,2,7
22,9,5,0.6989700043360189,1,4
23,9,8,0.9030899869919435,2,6
24,9,14,1.146128035678238,4,10
25,9,11,1.0413926851582251,2,9
26,9,16,1.2041199826559248,4,12
27,9,14,1.146128035678238,3,11
28,9,11,1.0413926851582251,2,9
29,9,14,1.146128035678238,4,10
30,9,14,1.146128035678238,7,7
31,9,20,1.3010299956639813,8,12
32,9,19,1.2787536009528289,3,16
33,9,20,1.3010299956639813,6,14
34,9,21,1.3222192947339193,6,15
35,9,16,1.2041199826559248,7,9
36,9,16,1.2041199826559248,6,10
37,9,14,1.146128035678238,1,13
38,9,18,1.255272505103306,7,11
39,9,30,1.4771212547196624,12,18
40,9,75,1.8750612633917,31,44
41,9,104,2.0170333392987803,50,54
42,9,317,2.5010592622177517,171,146
43,9,292,2.4653828514484184,151,141
44,9,437,2.640481436970422,282,155
45,9,421,2.6242820958356683,276,145
46,9,310,2.4913616938342726,215,95
47,9,313,2.4955443375464483,213,100
48,9,1365,3.1351326513767748,994,371
49,9,1408,3.1486026548060932,1019,389
50,9,1418,3.151676230847048,1011,407
51,9,1408,3.1486026548060932,1053,355
52,9,267,2.4265112613645754,174,93
53,9,266,2.424881636631067,191,75
54,9,412,2.6148972160331345,267,145
55,9,369,2.56702636615906,232,137
56,9,242,2.383815365980431,123,119
57,9,254,2.404833716619938,148,106
58,9,78,1.8920946026904804,38,40
59,9,64,1.806179973983887,31,33
60,9,15,1.1760912590556813,5,10
61,9,16,1.2041199826559248,4,12
62,9,12,1.0791812460476249,3,9
63,9,14,1.146128035678238,3,11
64,9,19,1.2787536009528289,8,11
65,9,21,1.3222192947339193,8,13
66,9,9,0.9542425094393249,3,6
67,9,15,1.1760912590556813,2,13
68,9,9,0.9542425094393249,2,7
69,9,16,1.2041199826559248,8,8
70,9,7,0.8450980400142568,1,6
71,9,15,1.1760912590556813,4,11
72,9,10,1.0,3,7
73,9,11,1.0413926851582251,2,9
74,9,13,1.1139433523068367,5,8
75,9,8,0.9030899869919435,3,5
76,9,9,0.9542425094393249,5,4
77,9,11,1.0413926851582251,6,5
78,9,14,1.146128035678238,7,7
79,9,11,1.0413926851582251,4,7
80,9,3,0.47712125471966244,0,3
81,9,3,0.47712125471966244,0,3
82,9,10,1.0,2,8
83,9,3,0.47712125471966244,1,2
84,9,7,0.8450980400142568,4,3
85,9,4,0.6020599913279624,2,2
86,9,7,0.8450980400142568,1,6
87,9,9,0.9542425094393249,3,6
88,9,1,0.0,0,1
89,9,4,0.6020599913279624,2,2
90,9,4,0.6020599913279624,2,2
91,9,4,0.6020599913279624,3,1
92,9,41,1.6127838567197355,7,34
93,9,63,1.7993405494535817,29,34
94,9,85,1.9294189257142926,34,51
95,9,81,1.9084850188786497,29,52
96,9,52,1.7160033436347992,17,35
97,9,45,1.6532125137753437,16,29
98,9,20,1.3010299956639813,5,15
99,9,22,1.3424226808222062,3,19
0,10,32,1.505149978319906,9,23
1,10,33,1.5185139398778875,10,23
2,10,102,2.0086001717619175,39,63
3,10,99,1.99563519459755,38,61
4,10,55,1.7403626894942439,17,38
5,10,58,1.7634279935629373,16,42
6,10,2,0.3010299956639812,1,1
7,10,2,0.3010299956639812,1,1
9,10,6,0.7781512503836436,2,4
10,10,4,0.6020599913279624,2,2
11,10,2,0.3010299956639812,0,2
12,10,3,0.47712125471966244,1,2
13,10,6,0.7781512503836436,2,4
14,10,6,0.7781512503836436,2,4
15,10,5,0.6989700043360189,1,4
16,10,4,0.6020599913279624,2,2
17,10,6,0.7781512503836436,0,6
18,10,6,0.7781512503836436,3,3
19,10,7,0.8450980400142568,2,5
20,10,10,1.0,4,6
21,10,9,0.9542425094393249,3,6
22,10,13,1.1139433523068367,5,8
23,10,6,0.7781512503836436,2,4
24,10,12,1.0791812460476249,5,7
25,10,13,1.1139433523068367,5,8
26,10,7,0.8450980400142568,3,4
27,10,6,0.7781512503836436,0,6
28,10,12,1.0791812460476249,4,8
29,10,14,1.146128035678238,3,11
30,10,15,1.1760912590556813,4,11
31,10,10,1.0,2,8
32,10,15,1.1760912590556813,5,10
33,10,16,1.2041199826559248,5,11
34,10,18,1.255272505103306,3,15
35,10,25,1.3979400086720377,11,14
36,10,24,1.380211241711606,11,13
37,10,22,1.3424226808222062,5,17
38,10,32,1.505149978319906,8,24
39,10,27,1.4313637641589874,11,16
40,10,106,2.0253058652647704,50,56
41,10,96,1.9822712330395684,32,64
42,10,311,2.4927603890268375,157,154
43,10,305,2.484299839346786,171,134
44,10,498,2.6972293427597176,297,201
45,10,467,2.6693168805661123,285,182
46,10,378,2.5774917998372255,249,129
47,10,388,2.5888317255942073,248,140
48,10,318,2.5024271199844326,233,85
49,10,359,2.5550944485783194,255,104
50,10,338,2.5289167002776547,241,97
51,10,333,2.5224442335063197,243,90
52,10,323,2.509202522331103,226,97
53,10,321,2.506505032404872,224,97
54,10,449,2.6522463410033232,261,188
55,10,477,2.678518379040114,287,190
56,10,282,2.450249108319361,155,127
57,10,298,2.4742162640762553,155,143
58,10,99,1.99563519459755,44,55
59,10,77,1.8864907251724818,39,38
60,10,22,1.3424226808222062,12,10
61,10,33,1.5185139398778875,13,20
62,10,20,1.3010299956639813,4,16
63,10,9,0.9542425094393249,3,6
64,10,19,1.2787536009528289,7,12
65,10,21,1.3222192947339193,11,10
66,10,18,1.255272505103306,5,13
67,10,17,1.2304489213782739,4,13
68,10,16,1.2041199826559248,6,10
69,10,16,1.2041199826559248,3,13
70,10,6,0.7781512503836436,1,5
71,10,4,0.6020599913279624,1,3
72,10,13,1.1139433523068367,5,8
73,10,20,1.3010299956639813,5,15
74,10,8,0.9030899869919435,2,6
75,10,10,1.0,2,8
76,10,6,0.7781512503836436,3,3
77,10,14,1.146128035678238,2,12
78,10,12,1.0791812460476249,4,8
79,10,8,0.9030899869919435,3,5
80,10,7,0.8450980400142568,2,5
81,10,7,0.8450980400142568,2,5
82,10,6,0.7781512503836436,1,5
83,10,7,0.8450980400142568,3,4
84,10,5,0.6989700043360189,1,4
85,10,6,0.7781512503836436,0,6
86,10,3,0.47712125471966244,1,2
87,10,3,0.47712125471966244,1,2
88,10,4,0.6020599913279624,1,3
89,10,6,0.7781512503836436,2,4
90,10,4,0.6020599913279624,3,1
91,10,6,0.7781512503836436,2,4
92,10,59,1.7708520116421442,23,36
93,10,65,1.8129133566428555,21,44
94,10,81,1.9084850188786497,29,52
95,10,67,1.8260748027008264,29,38
96,10,40,1.6020599913279623,7,33
97,10,33,1.5185139398778875,16,17
98,10,9,0.9542425094393249,1,8
99,10,11,1.0413926851582251,4,7
0,11,41,1.6127838567197355,15,26
1,11,22,1.3424226808222062,8,14
2,11,99,1.99563519459755,38,61
3,11,80,1.9030899869919435,32,48
4,11,61,1.7853298350107671,29,32
5,11,66,1.8195439355418688,24,42
6,11,1,0.0,1,0
7,11,3,0.47712125471966244,1,2
8,11,4,0.6020599913279624,2,2
9,11,7,0.8450980400142568,0,7
10,11,1,0.0,0,1
11,11,7,0.8450980400142568,3,4
12,11,5,0.6989700043360189,0,5
13,11,5,0.6989700043360189,3,2
14,11,9,0.9542425094393249,5,4
15,11,6,0.7781512503836436,1,5
16,11,11,1.0413926851582251,5,6
17,11,9,0.9542425094393249,5,4
18,11,10,1.0,5,5
19,11,9,0.9542425094393249,3,6
20,11,15,1.1760912590556813,5,10
21,11,18,1.255272505103306,5,13
22,11,8,0.9030899869919435,5,3
23,11,18,1.255272505103306,8,10
24,11,11,1.0413926851582251,5,6
25,11,10,1.0,4,6
26,11,11,1.0413926851582251,2,9
27,11,14,1.146128035678238,4,10
28,11,12,1.0791812460476249,4,8
29,11,12,1.0791812460476249,4,8
30,11,17,1.2304489213782739,3,14
31,11,16,1.2041199826559248,3,13
32,11,24,1.380211241711606,8,16
33,11,13,1.1139433523068367,6,7
34,11,26,1.414973347970818,4,22
35,11,21,1.3222192947339193,7,14
36,11,28,1.4471580313422192,7,21
37,11,20,1.3010299956639813,7,13
38,11,30,1.4771212547196624,12,18
39,11,29,1.462397997898956,8,21
40,11,100,2.0,46,54
41,11,92,1.9637878273455553,32,60
42,11,329,2.5171958979499744,170,159
43,11,311,2.4927603890268375,165,146
44,11,520,2.716003343634799,299,221
45,11,511,2.708420900134713,311,200
46,11,390,2.591064607026499,257,133
47,11,414,2.617000341120899,272,142
48,11,356,2.5514499979728753,252,104
49,11,313,2.4955443375464483,238,75
50,11,323,2.509202522331103,220,103
51,11,326,2.513217600067939,233,93
52,11,318,2.5024271199844326,219,99
53,11,363,2.5599066250361124,234,129
54,11,510,2.7075701760979363,292,218
55,11,441,2.6444385894678386,253,188
56,11,308,2.4885507165004443,161,147
57,11,284,2.4533183400470375,155,129
58,11,103,2.012837224705172,39,64
59,11,80,1.9030899869919435,39,41
60,11,23,1.3617278360175928,14,9
61,11,24,1.380211241711606,8,16
62,11,20,1.3010299956639813,6,14
63,11,16,1.2041199826559248,8,8
64,11,21,1.3222192947339193,3,18
65,11,21,1.3222192947339193,6,15
66,11,18,1.255272505103306,5,13
67,11,16,1.2041199826559248,3,13
68,11,16,1.2041199826559248,6,10
69,11,15,1.1760912590556813,4,11
70,11,17,1.2304489213782739,10,7
71,11,11,1.0413926851582251,4,7
72,11,12,1.0791812460476249,3,9
73,11,10,1.0,1,9
74,11,11,1.0413926851582251,5,6
75,11,17,1.2304489213782739,4,13
76,11,7,0.8450980400142568,1,6
77,11,12,1.0791812460476249,3,9
78,11,15,1.1760912590556813,7,8
79,11,13,1.1139433523068367,8,5
80,11,9,0.9542425094393249,4,5
81,11,12,1.0791812460476249,6,6
82,11,8,0.9030899869919435,6,2
83,11,8,0.9030899869919435,2,6
84,11,1,0.0,0,1
85,11,8,0.9030899869919435,5,3
86,11,6,0.7781512503836436,5,1
87,11,6,0.7781512503836436,3,3
88,11,8,0.9030899869919435,2,6
89,11,5,0.6989700043360189,0,5
90,11,3,0.47712125471966244,2,1
91,11,4,0.6020599913279624,2,2
92,11,45,1.6532125137753437,11,34
93,11,63,1.7993405494535817,23,40
94,11,75,1.8750612633917,24,51
95,11,74,1.8692317197309762,21,53
96,11,36,1.5563025007672873,9,27
97,11,32,1.505149978319906,9,23
98,11,11,1.0413926851582251,6,5
99,11,17,1.2304489213782739,7,10
0,12,25,1.3979400086720377,12,13
1,12,26,1.414973347970818,12,14
2,12,67,1.8260748027008264,25,42
3,12,65,1.8129133566428555,22,43
4,12,53,1.724275869600789,20,33
5,12,57,1.7558748556724915,18,39
6,12,1,0.0,1,0
7,12,2,0.3010299956639812,0,2
8,12,2,0.3010299956639812,2,0
9,12,1,0.0,0,1
10,12,3,0.47712125471966244,1,2
11,12,5,0.6989700043360189,3,2
12,12,6,0.7781512503836436,4,2
13,12,3,0.47712125471966244,0,3
14,12,5,0.6989700043360189,2,3
15,12,4,0.6020599913279624,1,3
16,12,3,0.47712125471966244,0,3
17,12,5,0.6989700043360189,1,4
18,12,13,1.1139433523068367,8,5
19,12,6,0.7781512503836436,1,5
20,12,13,1.1139433523068367,5,8
21,12,10,1.0,4,6
22,12,8,0.9030899869919435,3,5
23,12,11,1.0413926851582251,2,9
24,12,7,0.8450980400142568,2,5
25,12,12,1.0791812460476249,4,8
26,12,10,1.0,2,8
27,12,15,1.1760912590556813,8,7
28,12,9,0.9542425094393249,4,5
29,12,12,1.0791812460476249,2,10
30,12,12,1.0791812460476249,2,10
31,12,14,1.146128035678238,5,9
32,12,23,1.3617278360175928,9,14
33,12,15,1.1760912590556813,3,12
34,12,25,1.3979400086720377,5,20
35,12,23,1.3617278360175928,8,15
36,12,22,1.3424226808222062,10,12
37,12,26,1.414973347970818,11,15
38,12,25,1.3979400086720377,10,15
39,12,27,1.4313637641589874,11,16
40,12,65,1.8129133566428555,27,38
41,12,82,1.9138138523837167,38,44
42,12,240,2.380211241711606,114,126
43,12,237,2.374748346010104,117,120
44,12,384,2.584331224367531,221,163
45,12,376,2.575187844927661,217,159
46,12,346,2.5390760987927767,215,131
47,12,312,2.494154594018443,199,113
48,12,309,2.4899584794248346,226,83
49,12,296,2.4712917110589387,203,93
50,12,303,2.481442628502305,202,101
51,12,304,2.482873583608754,190,114
52,12,341,2.5327543789924976,205,136
53,12,337,2.5276299008713385,226,111
54,12,362,2.558708570533166,194,168
55,12,379,2.578639209968072,221,158
56,12,237,2.374748346010104,126,111
57,12,240,2.380211241711606,118,122
58,12,81,1.9084850188786497,40,41
59,12,66,1.8195439355418688,31,35
60,12,18,1.255272505103306,9,9
61,12,26,1.414973347970818,8,18
62,12,28,1.4471580313422192,9,19
63,12,38,1.5797835966168101,9,29
64,12,22,1.3424226808222062,9,13
65,12,20,1.3010299956639813,10,10
66,12,21,1.3222192947339193,7,14
67,12,18,1.255272505103306,2,16
68,12,11,1.0413926851582251,3,8
69,12,15,1.1760912590556813,5,10
70,12,7,0.8450980400142568,4,3
71,12,15,1.1760912590556813,8,7
72,12,15,1.1760912590556813,9,6
73,12,15,1.1760912590556813,5,10
74,12,8,0.9030899869919435,1,7
75,12,8,0.9030899869919435,2,6
76,12,6,0.7781512503836436,2,4
77,12,15,1.1760912590556813,6,9
78,12,9,0.9542425094393249,2,7
79,12,9,0.9542425094393249,3,6
80,12,17,1.2304489213782739,7,10
81,12,10,1.0,4,6
82,12,2,0.3010299956639812,0,2
83,12,8,0.9030899869919435,3,5
84,12,3,0.47712125471966244,1,2
85,12,6,0.7781512503836436,2,4
86,12,5,0.6989700043360189,1,4
87,12,7,0.8450980400142568,2,5
89,12,5,0.6989700043360189,0,5
90,12,2,0.3010299956639812,2,0
91,12,4,0.6020599913279624,2,2
92,12,45,1.6532125137753437,23,22
93,12,49,1.6901960800285136,19,30
94,12,71,1.8512583487190752,22,49
95,12,76,1.8808135922807914,26,50
96,12,21,1.3222192947339193,5,16
97,12,26,1.414973347970818,9,17
98,12,14,1.146128035678238,5,9
99,12,10,1.0,5,5
0,13,22,1.3424226808222062,10,12
1,13,21,1.3222192947339193,6,15
2,13,78,1.8920946026904804,25,53
3,13,92,1.9637878273455553,32,60
4,13,60,1.7781512503836436,21,39
5,13,51,1.7075701760979363,19,32
6,13,4,0.6020599913279624,2,2
7,13,2,0.3010299956639812,1,1
8,13,2,0.3010299956639812,0,2
9,13,8,0.9030899869919435,4,4
10,13,6,0.7781512503836436,2,4
11,13,3,0.47712125471966244,1,2
12,13,6,0.7781512503836436,2,4
13,13,4,0.6020599913279624,1,3
14,13,8,0.9030899869919435,5,3
15,13,8,0.9030899869919435,2,6
16,13,4,0.6020599913279624,1,3
17,13,1,0.0,1,0
18,13,6,0.7781512503836436,0,6
19,13,7,0.8450980400142568,4,3
20,13,11,1.0413926851582251,2,9
21,13,13,1.1139433523068367,5,8
22,13,11,1.0413926851582251,5,6
23,13,10,1.0,5,5
24,13,13,1.1139433523068367,4,9
25,13,10,1.0,2,8
26,13,6,0.7781512503836436,3,3
27,13,15,1.1760912590556813,5,10
28,13,15,1.1760912590556813,4,11
29,13,8,0.9030899869919435,2,6
30,13,15,1.1760912590556813,3,12
31,13,12,1.0791812460476249,4,8
32,13,20,1.3010299956639813,7,13
33,13,19,1.2787536009528289,6,13
34,13,26,1.414973347970818,4,22
35,13,22,1.3424226808222062,6,16
36,13,26,1.414973347970818,12,14
37,13,27,1.4313637641589874,6,21
38,13,35,1.5440680443502757,14,21
39,13,41,1.6127838567197355,13,28
40,13,67,1.8260748027008264,29,38
41,13,68,1.8325089127062364,33,35
42,13,210,2.322219294733919,117,93
43,13,217,2.3364597338485296,107,110
44,13,360,2.5563025007672873,204,156
45,13,379,2.578639209968072,219,160
46,13,344,2.53655844257153,227,117
47,13,326,2.513217600067939,205,121
48,13,334,2.5237464668115646,232,102
49,13,290,2.462397997898956,180,110
50,13,290,2.462397997898956,191,99
51,13,319,2.503790683057181,208,111
52,13,327,2.514547752660286,221,106
53,13,350,2.5440680443502757,218,132
54,13,355,2.550228353055094,215,140
55,13,374,2.5728716022004803,211,163
56,13,239,2.3783979009481375,120,119
57,13,230,2.361727836017593,116,114
58,13,67,1.8260748027008264,27,40
59,13,82,1.9138138523837167,29,53
60,13,41,1.6127838567197355,16,25
61,13,34,1.5314789170422551,11,23
62,13,27,1.4313637641589874,6,21
63,13,26,1.414973347970818,9,17
64,13,22,1.3424226808222062,7,15
65,13,27,1.4313637641589874,9,18
66,13,17,1.2304489213782739,10,7
67,13,17,1.2304489213782739,6,11
68,13,18,1.255272505103306,8,10
69,13,13,1.1139433523068367,5,8
70,13,14,1.146128035678238,1,13
71,13,16,1.2041199826559248,5,11
72,13,5,0.6989700043360189,1,4
73,13,14,1.146128035678238,3,11
74,13,9,0.9542425094393249,3,6
75,13,14,1.146128035678238,3,11
76,13,5,0.6989700043360189,0,5
77,13,16,1.2041199826559248,6,10
78,13,11,1.0413926851582251,2,9
79,13,7,0.8450980400142568,1,6
80,13,12,1.0791812460476249,3,9
81,13,4,0.6020599913279624,3,1
82,13,9,0.9542425094393249,4,5
83,13,3,0.47712125471966244,1,2
84,13,5,0.6989700043360189,2,3
85,13,5,0.6989700043360189,3,2
86,13,4,0.6020599913279624,0,4
87,13,4,0.6020599913279624,2,2
88,13,4,0.6020599913279624,3,1
89,13,4,0.6020599913279624,1,3
90,13,1,0.0,0,1
91,13,4,0.6020599913279624,1,3
92,13,45,1.6532125137753437,17,28
93,13,50,1.6989700043360187,20,30
94,13,60,1.7781512503836436,20,40
95,13,61,1.7853298350107671,19,42
96,13,28,1.4471580313422192,11,17
97,13,26,1.414973347970818,11,15
98,13,9,0.9542425094393249,5,4
99,13,13,1.1139433523068367,5,8
101,13,1,0.0,0,1
0,14,21,1.3222192947339193,9,12
1,14,16,1.2041199826559248,4,12
2,14,71,1.8512583487190752,26,45
3,14,59,1.7708520116421442,17,42
4,14,48,1.6812412373755872,20,28
5,14,40,1.6020599913279623,12,28
7,14,2,0.3010299956639812,1,1
8,14,3,0.47712125471966244,2,1
9,14,4,0.6020599913279624,1,3
10,14,4,0.6020599913279624,0,4
11,14,4,0.6020599913279624,2,2
13,14,5,0.6989700043360189,2,3
14,14,9,0.9542425094393249,4,5
15,14,2,0.3010299956639812,1,1
16,14,4,0.6020599913279624,2,2
17,14,11,1.0413926851582251,2,9
18,14,6,0.7781512503836436,2,4
19,14,8,0.9030899869919435,4,4
20,14,13,1.1139433523068367,3,10
21,14,7,0.8450980400142568,2,5
22,14,9,0.9542425094393249,2,7
23,14,14,1.146128035678238,5,9
24,14,7,0.8450980400142568,3,4
25,14,11,1.0413926851582251,3,8
26,14,16,1.2041199826559248,5,11
27,14,10,1.0,2,8
28,14,8,0.9030899869919435,2,6
29,14,17,1.2304489213782739,6,11
30,14,11,1.0413926851582251,3,8
31,14,19,1.2787536009528289,6,13
32,14,16,1.2041199826559248,3,13
33,14,12,1.0791812460476249,1,11
34,14,16,1.2041199826559248,4,12
35,14,20,1.3010299956639813,7,13
36,14,20,1.3010299956639813,10,10
37,14,33,1.5185139398778875,12,21
38,14,28,1.4471580313422192,8,20
39,14,33,1.5185139398778875,15,18
40,14,51,1.7075701760979363,22,29
41,14,47,1.6720978579357175,19,28
42,14,130,2.113943352306837,55,75
43,14,144,2.1583624920952498,63,81
44,14,231,2.3636119798921444,129,102
45,14,259,2.413299764081252,142,117
46,14,246,2.3909351071033793,154,92
47,14,223,2.3483048630481607,142,81
48,14,292,2.4653828514484184,195,97
49,14,265,2.423245873936808,162,103
50,14,286,2.456366033129043,188,98
51,14,260,2.4149733479708178,170,90
52,14,284,2.4533183400470375,181,103
53,14,248,2.3944516808262164,164,84
54,14,274,2.437750562820388,174,100
55,14,290,2.462397997898956,181,109
56,14,181,2.2576785748691846,87,94
57,14,146,2.164352855784437,72,74
58,14,71,1.8512583487190752,21,50
59,14,65,1.8129133566428555,24,41
60,14,37,1.568201724066995,12,25
61,14,38,1.5797835966168101,13,25
62,14,18,1.255272505103306,3,15
63,14,26,1.414973347970818,11,15
64,14,23,1.3617278360175928,5,18
65,14,28,1.4471580313422192,9,19
66,14,15,1.1760912590556813,6,9
67,14,25,1.3979400086720377,8,17
68,14,21,1.3222192947339193,8,13
69,14,14,1.146128035678238,10,4
70,14,9,0.9542425094393249,3,6
71,14,6,0.7781512503836436,1,5
72,14,7,0.8450980400142568,3,4
73,14,7,0.8450980400142568,3,4
74,14,6,0.7781512503836436,1,5
75,14,13,1.1139433523068367,7,6
76,14,10,1.0,4,6
77,14,10,1.0,2,8
78,14,9,0.9542425094393249,5,4
79,14,7,0.8450980400142568,3,4
80,14,5,0.6989700043360189,4,1
81,14,14,1.146128035678238,5,9
82,14,6,0.7781512503836436,1,5
83,14,11,1.0413926851582251,6,5
84,14,6,0.7781512503836436,1,5
85,14,3,0.47712125471966244,0,3
86,14,3,0.47712125471966244,1,2
87,14,3,0.47712125471966244,1,2
88,14,4,0.6020599913279624,1,3
89,14,5,0.6989700043360189,1,4
90,14,3,0.47712125471966244,1,2
91,14,5,0.6989700043360189,1,4
92,14,40,1.6020599913279623,15,25
93,14,41,1.6127838567197355,15,26
94,14,48,1.6812412373755872,9,39
95,14,53,1.724275869600789,16,37
96,14,22,1.3424226808222062,9,13
97,14,15,1.1760912590556813,5,10
98,14,4,0.6020599913279624,2,2
99,14,8,0.9030899869919435,3,5
0,15,23,1.3617278360175928,10,13
1,15,15,1.1760912590556813,2,13
2,15,71,1.8512583487190752,28,43
3,15,65,1.8129133566428555,21,44
4,15,52,1.7160033436347992,21,31
5,15,43,1.6334684555795864,15,28
6,15,2,0.3010299956639812,0,2
7,15,5,0.6989700043360189,1,4
8,15,3,0.47712125471966244,2,1
9,15,1,0.0,0,1
10,15,3,0.47712125471966244,2,1
11,15,5,0.6989700043360189,2,3
12,15,3,0.47712125471966244,3,0
13,15,3,0.47712125471966244,1,2
14,15,5,0.6989700043360189,2,3
15,15,6,0.7781512503836436,1,5
16,15,11,1.0413926851582251,6,5
17,15,13,1.1139433523068367,6,7
18,15,9,0.9542425094393249,2,7
19,15,6,0.7781512503836436,1,5
20,15,9,0.9542425094393249,4,5
21,15,9,0.9542425094393249,3,6
22,15,6,0.7781512503836436,3,3
23,15,8,0.9030899869919435,5,3
24,15,10,1.0,4,6
25,15,14,1.146128035678238,2,12
26,15,6,0.7781512503836436,3,3
27,15,13,1.1139433523068367,6,7
28,15,20,1.3010299956639813,10,10
29,15,13,1.1139433523068367,4,9
30,15,7,0.8450980400142568,3,4
31,15,11,1.0413926851582251,4,7
32,15,16,1.2041199826559248,5,11
33,15,19,1.2787536009528289,4,15
34,15,22,1.3424226808222062,6,16
35,15,27,1.4313637641589874,7,20
36,15,24,1.380211241711606,10,14
37,15,32,1.505149978319906,10,22
38,15,49,1.6901960800285136,15,34
39,15,36,1.5563025007672873,15,21
40,15,55,1.7403626894942439,19,36
41,15,52,1.7160033436347992,19,33
42,15,155,2.1903316981702914,74,81
43,15,122,2.0863598306747484,65,57
44,15,214,2.330413773349191,113,101
45,15,230,2.361727836017593,119,111
46,15,244,2.387389826338729,146,98
47,15,254,2.404833716619938,146,108
48,15,266,2.424881636631067,162,104
49,15,253,2.403120521175818,164,89
50,15,258,2.41161970596323,164,94
51,15,247,2.392696953259666,152,95
52,15,237,2.374748346010104,148,89
53,15,263,2.419955748489758,159,104
54,15,259,2.413299764081252,147,112
55,15,257,2.4099331233312946,135,122
56,15,171,2.2329961103921536,87,84
57,15,165,2.2174839442139063,72,93
58,15,67,1.8260748027008264,33,34
59,15,67,1.8260748027008264,28,39
60,15,38,1.5797835966168101,14,24
61,15,38,1.5797835966168101,14,24
62,15,23,1.3617278360175928,9,14
63,15,21,1.3222192947339193,7,14
64,15,24,1.380211241711606,8,16
65,15,22,1.3424226808222062,6,16
66,15,18,1.255272505103306,7,11
67,15,22,1.3424226808222062,8,14
68,15,13,1.1139433523068367,3,10
69,15,11,1.0413926851582251,5,6
70,15,10,1.0,0,10
71,15,9,0.9542425094393249,4,5
72,15,13,1.1139433523068367,10,3
73,15,20,1.3010299956639813,5,15
74,15,7,0.8450980400142568,4,3
75,15,10,1.0,4,6
76,15,5,0.6989700043360189,2,3
77,15,8,0.9030899869919435,2,6
78,15,11,1.0413926851582251,4,7
79,15,8,0.9030899869919435,3,5
80,15,7,0.8450980400142568,1,6
81,15,10,1.0,5,5
82,15,9,0.9542425094393249,2,7
83,15,5,0.6989700043360189,0,5
84,15,3,0.47712125471966244,1,2
85,15,3,0.47712125471966244,2,1
86,15,4,0.6020599913279624,1,3
87,15,5,0.6989700043360189,2,3
88,15,4,0.6020599913279624,0,4
89,15,1,0.0,1,0
90,15,1,0.0,0,1
91,15,1,0.0,0,1
92,15,48,1.6812412373755872,21,27
93,15,46,1.662757831681574,18,28
94,15,67,1.8260748027008264,27,40
95,15,53,1.724275869600789,17,36
96,15,24,1.380211241711606,10,14
97,15,21,1.3222192947339193,7,14
98,15,9,0.9542425094393249,4,5
99,15,12,1.0791812460476249,3,9
0,16,14,1.146128035678238,5,9
1,16,8,0.9030899869919435,2,6
2,16,50,1.6989700043360187,16,34
3,16,46,1.662757831681574,18,28
4,16,38,1.5797835966168101,14,24
5,16,37,1.568201724066995,11,26
6,16,1,0.0,1,0
7,16,5,0.6989700043360189,0,5
8,16,5,0.6989700043360189,2,3
9,16,3,0.47712125471966244,2,1
11,16,5,0.6989700043360189,3,2
12,16,5,0.6989700043360189,3,2
13,16,4,0.6020599913279624,1,3
14,16,1,0.0,0,1
15,16,8,0.9030899869919435,3,5
16,16,5,0.6989700043360189,0,5
17,16,9,0.9542425094393249,5,4
18,16,6,0.7781512503836436,3,3
19,16,4,0.6020599913279624,1,3
20,16,5,0.6989700043360189,2,3
21,16,11,1.0413926851582251,2,9
22,16,7,0.8450980400142568,3,4
23,16,15,1.1760912590556813,6,9
24,16,9,0.9542425094393249,1,8
25,16,14,1.146128035678238,2,12
26,16,10,1.0,4,6
27,16,8,0.9030899869919435,3,5
28,16,8,0.9030899869919435,5,3
29,16,7,0.8450980400142568,4,3
30,16,16,1.2041199826559248,5,11
31,16,9,0.9542425094393249,1,8
32,16,21,1.3222192947339193,5,16
33,16,15,1.1760912590556813,3,12
34,16,23,1.3617278360175928,5,18
35,16,24,1.380211241711606,8,16
36,16,29,1.462397997898956,6,23
37,16,22,1.3424226808222062,7,15
38,16,33,1.5185139398778875,11,22
39,16,39,1.591064607026499,7,32
40,16,44,1.6434526764861874,21,23
41,16,43,1.6334684555795864,16,27
42,16,78,1.8920946026904804,39,39
43,16,97,1.9867717342662448,27,70
44,16,121,2.0827853703164503,72,49
45,16,141,2.1492191126553797,74,67
46,16,161,2.2068258760318495,100,61
47,16,135,2.130333768495006,73,62
48,16,198,2.296665190261531,115,83
49,16,201,2.303196057420489,125,76
50,16,182,2.2600713879850747,128,54
51,16,200,2.3010299956639813,121,79
52,16,163,2.2121876044039577,98,65
53,16,151,2.1789769472931693,93,58
54,16,172,2.2355284469075487,92,80
55,16,142,2.1522883443830563,84,58
56,16,98,1.9912260756924949,50,48
57,16,87,1.9395192526186185,40,47
58,16,59,1.7708520116421442,20,39
59,16,46,1.662757831681574,15,31
60,16,31,1.4913616938342726,14,17
61,16,25,1.3979400086720377,10,15
62,16,23,1.3617278360175928,7,16
63,16,30,1.4771212547196624,10,20
64,16,14,1.146128035678238,5,9
65,16,26,1.414973347970818,10,16
66,16,15,1.1760912590556813,8,7
67,16,16,1.2041199826559248,9,7
68,16,13,1.1139433523068367,5,8
69,16,15,1.1760912590556813,4,11
70,16,8,0.9030899869919435,1,7
71,16,16,1.2041199826559248,6,10
72,16,6,0.7781512503836436,3,3
73,16,14,1.146128035678238,5,9
74,16,8,0.9030899869919435,1,7
75,16,7,0.8450980400142568,2,5
76,16,10,1.0,3,7
77,16,8,0.9030899869919435,4,4
78,16,7,0.8450980400142568,2,5
79,16,9,0.9542425094393249,3,6
80,16,7,0.8450980400142568,3,4
81,16,5,0.6989700043360189,1,4
82,16,6,0.7781512503836436,2,4
83,16,6,0.7781512503836436,0,6
84,16,5,0.6989700043360189,0,5
85,16,8,0.9030899869919435,3,5
86,16,3,0.47712125471966244,1,2
87,16,2,0.3010299956639812,0,2
88,16,1,0.0,0,1
89,16,1,0.0,1,0
90,16,3,0.47712125471966244,1,2
91,16,1,0.0,0,1
92,16,36,1.5563025007672873,16,20
93,16,26,1.414973347970818,11,15
94,16,52,1.7160033436347992,21,31
95,16,61,1.7853298350107671,19,42
96,16,17,1.2304489213782739,7,10
97,16,13,1.1139433523068367,3,10
98,16,8,0.9030899869919435,2,6
99,16,4,0.6020599913279624,0,4
0,17,10,1.0,3,7
1,17,7,0.8450980400142568,4,3
2,17,52,1.7160033436347992,14,38
3,17,41,1.6127838567197355,16,25
4,17,35,1.5440680443502757,15,20
5,17,43,1.6334684555795864,21,22
6,17,4,0.6020599913279624,3,1
7,17,1,0.0,1,0
8,17,5,0.6989700043360189,4,1
9,17,2,0.3010299956639812,1,1
10,17,1,0.0,1,0
11,17,3,0.47712125471966244,2,1
12,17,5,0.6989700043360189,3,2
13,17,5,0.6989700043360189,2,3
14,17,3,0.47712125471966244,1,2
15,17,2,0.3010299956639812,0,2
16,17,6,0.7781512503836436,2,4
17,17,7,0.8450980400142568,5,2
18,17,7,0.8450980400142568,0,7
19,17,9,0.9542425094393249,3,6
20,17,6,0.7781512503836436,2,4
21,17,7,0.8450980400142568,3,4
22,17,4,0.6020599913279624,0,4
23,17,13,1.1139433523068367,5,8
24,17,9,0.9542425094393249,3,6
25,17,11,1.0413926851582251,5,6
26,17,19,1.2787536009528289,6,13
27,17,10,1.0,4,6
28,17,13,1.1139433523068367,4,9
29,17,7,0.8450980400142568,4,3
30,17,14,1.146128035678238,6,8
31,17,9,0.9542425094393249,2,7
32,17,21,1.3222192947339193,7,14
33,17,12,1.0791812460476249,2,10
34,17,25,1.3979400086720377,6,19
35,17,28,1.4471580313422192,5,23
36,17,27,1.4313637641589874,10,17
37,17,28,1.4471580313422192,13,15
38,17,39,1.591064607026499,11,28
39,17,45,1.6532125137753437,17,28
40,17,49,1.6901960800285136,13,36
41,17,54,1.7323937598229686,17,37
42,17,75,1.8750612633917,34,41
43,17,99,1.99563519459755,34,65
44,17,119,2.0755469613925306,61,58
45,17,104,2.0170333392987803,56,48
46,17,131,2.1172712956557644,72,59
47,17,117,2.0681858617461617,57,60
48,17,177,2.247973266361807,113,64
49,17,140,2.146128035678238,85,55
50,17,169,2.2278867046136734,120,49
51,17,174,2.2405492482826,100,74
52,17,149,2.173186268412274,77,72
53,17,137,2.1367205671564067,85,52
54,17,126,2.100370545117563,70,56
55,17,132,2.12057393120585,77,55
56,17,104,2.0170333392987803,45,59
57,17,93,1.968482948553935,42,51
58,17,54,1.7323937598229686,20,34
59,17,54,1.7323937598229686,25,29
60,17,33,1.5185139398778875,5,28
61,17,45,1.6532125137753437,17,28
62,17,30,1.4771212547196624,8,22
63,17,30,1.4771212547196624,11,19
64,17,16,1.2041199826559248,7,9
65,17,26,1.414973347970818,8,18
66,17,16,1.2041199826559248,6,10
67,17,10,1.0,2,8
68,17,14,1.146128035678238,6,8
69,17,16,1.2041199826559248,3,13
70,17,9,0.9542425094393249,2,7
71,17,9,0.9542425094393249,3,6
72,17,11,1.0413926851582251,4,7
73,17,13,1.1139433523068367,2,11
74,17,9,0.9542425094393249,3,6
75,17,12,1.0791812460476249,4,8
76,17,14,1.146128035678238,4,10
77,17,6,0.7781512503836436,4,2
78,17,6,0.7781512503836436,2,4
79,17,12,1.0791812460476249,2,10
80,17,9,0.9542425094393249,1,8
81,17,13,1.1139433523068367,4,9
82,17,6,0.7781512503836436,3,3
83,17,3,0.47712125471966244,1,2
84,17,8,0.9030899869919435,3,5
85,17,2,0.3010299956639812,2,0
86,17,3,0.47712125471966244,3,0
87,17,5,0.6989700043360189,2,3
88,17,5,0.6989700043360189,2,3
89,17,3,0.47712125471966244,1,2
90,17,1,0.0,1,0
91,17,2,0.3010299956639812,1,1
92,17,42,1.6232492903979006,15,27
93,17,29,1.462397997898956,8,21
94,17,48,1.6812412373755872,19,29
95,17,54,1.7323937598229686,18,36
96,17,15,1.1760912590556813,4,11
97,17,19,1.2787536009528289,7,12
98,17,4,0.6020599913279624,1,3
99,17,3,0.47712125471966244,1,2
0,18,10,1.0,5,5
1,18,10,1.0,5,5
2,18,42,1.6232492903979006,15,27
3,18,38,1.5797835966168101,10,28
4,18,33,1.5185139398778875,13,20
5,18,43,1.6334684555795864,10,33
6,18,5,0.6989700043360189,2,3
7,18,7,0.8450980400142568,2,5
8,18,2,0.3010299956639812,0,2
9,18,1,0.0,0,1
10,18,1,0.0,0,1
11,18,1,0.0,0,1
12,18,2,0.3010299956639812,2,0
13,18,4,0.6020599913279624,0,4
14,18,5,0.6989700043360189,0,5
15,18,5,0.6989700043360189,2,3
16,18,6,0.7781512503836436,1,5
17,18,4,0.6020599913279624,2,2
18,18,3,0.47712125471966244,2,1
19,18,6,0.7781512503836436,2,4
20,18,6,0.7781512503836436,2,4
21,18,7,0.8450980400142568,5,2
22,18,9,0.9542425094393249,0,9
23,18,11,1.0413926851582251,3,8
24,18,9,0.9542425094393249,3,6
25,18,7,0.8450980400142568,1,6
26,18,6,0.7781512503836436,3,3
27,18,6,0.7781512503836436,0,6
28,18,11,1.0413926851582251,3,8
29,18,11,1.0413926851582251,4,7
30,18,10,1.0,3,7
31,18,14,1.146128035678238,7,7
32,18,16,1.2041199826559248,8,8
33,18,11,1.0413926851582251,4,7
34,18,21,1.3222192947339193,5,16
35,18,16,1.2041199826559248,5,11
36,18,27,1.4313637641589874,5,22
37,18,23,1.3617278360175928,9,14
38,18,46,1.662757831681574,13,33
39,18,30,1.4771212547196624,8,22
40,18,51,1.7075701760979363,15,36
41,18,51,1.7075701760979363,16,35
42,18,50,1.6989700043360187,15,35
43,18,63,1.7993405494535817,21,42
44,18,71,1.8512583487190752,26,45
45,18,54,1.7323937598229686,22,32
46,18,87,1.9395192526186185,38,49
47,18,90,1.954242509439325,48,42
48,18,135,2.130333768495006,82,53
49,18,113,2.0530784434834195,48,65
50,18,128,2.1072099696478683,80,48
51,18,153,2.184691430817599,84,69
52,18,94,1.9731278535996986,46,48
53,18,113,2.0530784434834195,59,54
54,18,105,2.0211892990699383,51,54
55,18,73,1.863322860120456,43,30
56,18,62,1.792391689498254,22,40
57,18,78,1.8920946026904804,26,52
58,18,50,1.6989700043360187,14,36
59,18,35,1.5440680443502757,13,22
60,18,37,1.568201724066995,17,20
61,18,27,1.4313637641589874,11,16
62,18,24,1.380211241711606,6,18
63,18,33,1.5185139398778875,11,22
64,18,20,1.3010299956639813,8,12
65,18,18,1.255272505103306,5,13
66,18,13,1.1139433523068367,2,11
67,18,10,1.0,5,5
68,18,18,1.255272505103306,2,16
69,18,12,1.0791812460476249,5,7
70,18,11,1.0413926851582251,2,9
71,18,4,0.6020599913279624,0,4
72,18,14,1.146128035678238,6,8
73,18,8,0.9030899869919435,3,5
74,18,7,0.8450980400142568,2,5
75,18,7,0.8450980400142568,2,5
76,18,7,0.8450980400142568,1,6
77,18,6,0.7781512503836436,6,0
78,18,13,1.1139433523068367,4,9
79,18,6,0.7781512503836436,2,4
80,18,7,0.8450980400142568,3,4
81,18,5,0.6989700043360189,2,3
82,18,3,0.47712125471966244,0,3
83,18,3,0.47712125471966244,2,1
84,18,2,0.3010299956639812,2,0
85,18,3,0.47712125471966244,1,2
86,18,3,0.47712125471966244,0,3
87,18,5,0.6989700043360189,0,5
88,18,1,0.0,0,1
89,18,2,0.3010299956639812,1,1
91,18,3,0.47712125471966244,0,3
92,18,35,1.5440680443502757,12,23
93,18,37,1.568201724066995,8,29
94,18,34,1.5314789170422551,7,27
95,18,45,1.6532125137753437,12,33
96,18,12,1.0791812460476249,6,6
97,18,12,1.0791812460476249,1,11
98,18,2,0.3010299956639812,1,1
99,18,8,0.9030899869919435,2,6
0,19,6,0.7781512503836436,3,3
1,19,8,0.9030899869919435,2,6
2,19,40,1.6020599913279623,20,20
3,19,41,1.6127838567197355,16,25
4,19,43,1.6334684555795864,16,27
5,19,36,1.5563025007672873,20,16
6,19,2,0.3010299956639812,0,2
7,19,4,0.6020599913279624,2,2
8,19,1,0.0,0,1
9,19,2,0.3010299956639812,2,0
10,19,4,0.6020599913279624,1,3
11,19,1,0.0,0,1
12,19,5,0.6989700043360189,2,3
13,19,1,0.0,0,1
14,19,4,0.6020599913279624,0,4
15,19,3,0.47712125471966244,0,3
16,19,5,0.6989700043360189,0,5
17,19,7,0.8450980400142568,3,4
18,19,6,0.7781512503836436,2,4
19,19,5,0.6989700043360189,2,3
20,19,3,0.47712125471966244,0,3
21,19,10,1.0,4,6
22,19,11,1.0413926851582251,5,6
23,19,11,1.0413926851582251,3,8
24,19,8,0.9030899869919435,4,4
25,19,14,1.146128035678238,5,9
26,19,13,1.1139433523068367,1,12
27,19,12,1.0791812460476249,2,10
28,19,7,0.8450980400142568,2,5
29,19,10,1.0,4,6
30,19,11,1.0413926851582251,4,7
31,19,9,0.9542425094393249,1,8
32,19,13,1.1139433523068367,1,12
33,19,15,1.1760912590556813,13,2
34,19,16,1.2041199826559248,9,7
35,19,21,1.3222192947339193,7,14
36,19,28,1.4471580313422192,6,22
37,19,28,1.4471580313422192,11,17
38,19,33,1.5185139398778875,14,19
39,19,29,1.462397997898956,5,24
40,19,55,1.7403626894942439,17,38
41,19,39,1.591064607026499,11,28
42,19,48,1.6812412373755872,17,31
43,19,57,1.7558748556724915,19,38
44,19,72,1.8573324964312685,25,47
45,19,60,1.7781512503836436,19,41
46,19,84,1.9242792860618816,40,44
47,19,77,1.8864907251724818,34,43
48,19,107,2.0293837776852097,49,58
49,19,113,2.0530784434834195,61,52
50,19,139,2.143014800254095,69,70
51,19,129,2.110589710299249,74,55
52,19,75,1.8750612633917,35,40
53,19,89,1.9493900066449128,45,44
54,19,67,1.8260748027008264,24,43
55,19,72,1.8573324964312685,31,41
56,19,64,1.806179973983887,28,36
57,19,54,1.7323937598229686,18,36
58,19,61,1.7853298350107671,18,43
59,19,51,1.7075701760979363,18,33
60,19,35,1.5440680443502757,14,21
61,19,25,1.3979400086720377,3,22
62,19,28,1.4471580313422192,12,16
63,19,21,1.3222192947339193,8,13
64,19,14,1.146128035678238,2,12
65,19,26,1.414973347970818,12,14
66,19,13,1.1139433523068367,3,10
67,19,17,1.2304489213782739,3,14
68,19,11,1.0413926851582251,3,8
69,19,8,0.9030899869919435,5,3
70,19,8,0.9030899869919435,1,7
71,19,10,1.0,2,8
72,19,9,0.9542425094393249,4,5
73,19,9,0.9542425094393249,2,7
74,19,9,0.9542425094393249,3,6
75,19,8,0.9030899869919435,3,5
76,19,6,0.7781512503836436,3,3
77,19,9,0.9542425094393249,1,8
78,19,3,0.47712125471966244,2,1
79,19,7,0.8450980400142568,2,5
80,19,6,0.7781512503836436,1,5
81,19,3,0.47712125471966244,1,2
82,19,6,0.7781512503836436,2,4
83,19,6,0.7781512503836436,3,3
84,19,2,0.3010299956639812,0,2
85,19,2,0.3010299956639812,1,1
86,19,5,0.6989700043360189,1,4
87,19,6,0.7781512503836436,2,4
88,19,1,0.0,0,1
89,19,5,0.6989700043360189,2,3
90,19,2,0.3010299956639812,1,1
91,19,5,0.6989700043360189,2,3
92,19,24,1.380211241711606,9,15
93,19,34,1.5314789170422551,11,23
94,19,51,1.7075701760979363,18,33
95,19,44,1.6434526764861874,13,31
96,19,20,1.3010299956639813,5,15
97,19,17,1.2304489213782739,8,9
98,19,6,0.7781512503836436,1,5
99,19,3,0.47712125471966244,0,3
101,19,1,0.0,0,1
0,20,5,0.6989700043360189,2,3
1,20,9,0.9542425094393249,6,3
2,20,31,1.4913616938342726,10,21
3,20,38,1.5797835966168101,11,27
4,20,35,1.5440680443502757,9,26
5,20,36,1.5563025007672873,15,21
6,20,7,0.8450980400142568,4,3
7,20,5,0.6989700043360189,4,1
8,20,3,0.47712125471966244,2,1
10,20,2,0.3010299956639812,1,1
11,20,2,0.3010299956639812,0,2
12,20,3,0.47712125471966244,1,2
13,20,3,0.47712125471966244,1,2
14,20,1,0.0,0,1
15,20,1,0.0,1,0
16,20,4,0.6020599913279624,1,3
17,20,1,0.0,1,0
18,20,6,0.7781512503836436,1,5
19,20,3,0.47712125471966244,1,2
20,20,9,0.9542425094393249,5,4
21,20,6,0.7781512503836436,2,4
22,20,3,0.47712125471966244,2,1
23,20,10,1.0,2,8
24,20,13,1.1139433523068367,3,10
25,20,4,0.6020599913279624,1,3
26,20,5,0.6989700043360189,0,5
27,20,7,0.8450980400142568,1,6
28,20,6,0.7781512503836436,0,6
29,20,13,1.1139433523068367,4,9
30,20,10,1.0,5,5
31,20,5,0.6989700043360189,1,4
32,20,6,0.7781512503836436,3,3
33,20,10,1.0,2,8
34,20,17,1.2304489213782739,6,11
35,20,17,1.2304489213782739,7,10
36,20,14,1.146128035678238,4,10
37,20,26,1.414973347970818,11,15
38,20,32,1.505149978319906,9,23
39,20,28,1.4471580313422192,4,24
40,20,48,1.6812412373755872,20,28
41,20,42,1.6232492903979006,14,28
42,20,57,1.7558748556724915,29,28
43,20,49,1.6901960800285136,22,27
44,20,45,1.6532125137753437,21,24
45,20,53,1.724275869600789,21,32
46,20,75,1.8750612633917,40,35
47,20,51,1.7075701760979363,21,30
48,20,76,1.8808135922807914,27,49
49,20,102,2.0086001717619175,49,53
50,20,100,2.0,51,49
51,20,99,1.99563519459755,53,46
52,20,67,1.8260748027008264,34,33
53,20,64,1.806179973983887,31,33
54,20,51,1.7075701760979363,27,24
55,20,49,1.6901960800285136,20,29
56,20,49,1.6901960800285136,21,28
57,20,46,1.662757831681574,14,32
58,20,44,1.6434526764861874,13,31
59,20,40,1.6020599913279623,17,23
60,20,28,1.4471580313422192,10,18
61,20,34,1.5314789170422551,8,26
62,20,25,1.3979400086720377,13,12
63,20,20,1.3010299956639813,5,15
64,20,25,1.3979400086720377,11,14
65,20,21,1.3222192947339193,7,14
66,20,9,0.9542425094393249,3,6
67,20,20,1.3010299956639813,6,14
68,20,11,1.0413926851582251,3,8
69,20,9,0.9542425094393249,4,5
70,20,6,0.7781512503836436,3,3
71,20,8,0.9030899869919435,3,5
72,20,8,0.9030899869919435,5,3
73,20,12,1.0791812460476249,4,8
74,20,9,0.9542425094393249,4,5
75,20,6,0.7781512503836436,4,2
76,20,6,0.7781512503836436,0,6
77,20,6,0.7781512503836436,4,2
78,20,11,1.0413926851582251,2,9
79,20,6,0.7781512503836436,4,2
80,20,2,0.3010299956639812,1,1
81,20,6,0.7781512503836436,2,4
82,20,7,0.8450980400142568,1,6
83,20,6,0.7781512503836436,4,2
84,20,7,0.8450980400142568,2,5
86,20,7,0.8450980400142568,1,6
87,20,4,0.6020599913279624,1,3
88,20,5,0.6989700043360189,3,2
89,20,2,0.3010299956639812,0,2
90,20,1,0.0,0,1
91,20,1,0.0,0,1
92,20,28,1.4471580313422192,7,21
93,20,36,1.5563025007672873,9,27
94,20,36,1.5563025007672873,17,19
95,20,47,1.6720978579357175,14,33
96,20,14,1.146128035678238,3,11
97,20,7,0.8450980400142568,4,3
98,20,4,0.6020599913279624,1,3
99,20,4,0.6020599913279624,1,3
0,21,8,0.9030899869919435,2,6
1,21,3,0.47712125471966244,1,2
2,21,45,1.6532125137753437,21,24
3,21,31,1.4913616938342726,11,20
4,21,27,1.4313637641589874,9,18
5,21,36,1.5563025007672873,13,23
6,21,14,1.146128035678238,6,8
7,21,11,1.0413926851582251,6,5
8,21,1,0.0,0,1
10,21,3,0.47712125471966244,1,2
11,21,2,0.3010299956639812,1,1
13,21,3,0.47712125471966244,1,2
14,21,2,0.3010299956639812,0,2
15,21,6,0.7781512503836436,3,3
16,21,3,0.47712125471966244,0,3
17,21,2,0.3010299956639812,2,0
18,21,4,0.6020599913279624,1,3
19,21,3,0.47712125471966244,1,2
20,21,6,0.7781512503836436,1,5
21,21,8,0.9030899869919435,2,6
22,21,7,0.8450980400142568,0,7
23,21,8,0.9030899869919435,3,5
24,21,10,1.0,2,8
25,21,9,0.9542425094393249,1,8
26,21,8,0.9030899869919435,1,7
27,21,8,0.9030899869919435,1,7
28,21,13,1.1139433523068367,3,10
29,21,7,0.8450980400142568,2,5
30,21,10,1.0,3,7
31,21,9,0.9542425094393249,2,7
32,21,9,0.9542425094393249,4,5
33,21,18,1.255272505103306,7,11
34,21,11,1.0413926851582251,3,8
35,21,14,1.146128035678238,6,8
36,21,18,1.255272505103306,6,12
37,21,22,1.3424226808222062,9,13
38,21,23,1.3617278360175928,9,14
39,21,37,1.568201724066995,17,20
40,21,62,1.792391689498254,20,42
41,21,52,1.7160033436347992,22,30
42,21,54,1.7323937598229686,18,36
43,21,43,1.6334684555795864,12,31
44,21,46,1.662757831681574,11,35
45,21,39,1.591064607026499,13,26
46,21,53,1.724275869600789,23,30
47,21,55,1.7403626894942439,23,32
48,21,95,1.9777236052888478,41,54
49,21,113,2.0530784434834195,57,56
50,21,102,2.0086001717619175,47,55
51,21,87,1.9395192526186185,29,58
52,21,57,1.7558748556724915,25,32
53,21,74,1.8692317197309762,29,45
54,21,42,1.6232492903979006,20,22
55,21,47,1.6720978579357175,17,30
56,21,50,1.6989700043360187,16,34
57,21,49,1.6901960800285136,19,30
58,21,46,1.662757831681574,18,28
59,21,33,1.5185139398778875,15,18
60,21,33,1.5185139398778875,12,21
61,21,34,1.5314789170422551,7,27
62,21,23,1.3617278360175928,5,18
63,21,15,1.1760912590556813,7,8
64,21,17,1.2304489213782739,4,13
65,21,23,1.3617278360175928,7,16
66,21,11,1.0413926851582251,1,10
67,21,15,1.1760912590556813,8,7
68,21,5,0.6989700043360189,2,3
69,21,8,0.9030899869919435,3,5
70,21,5,0.6989700043360189,2,3
71,21,12,1.0791812460476249,2,10
72,21,9,0.9542425094393249,4,5
73,21,11,1.0413926851582251,3,8
74,21,10,1.0,4,6
75,21,9,0.9542425094393249,3,6
76,21,8,0.9030899869919435,1,7
77,21,8,0.9030899869919435,2,6
78,21,3,0.47712125471966244,0,3
79,21,7,0.8450980400142568,3,4
80,21,3,0.47712125471966244,1,2
81,21,8,0.9030899869919435,3,5
82,21,5,0.6989700043360189,1,4
83,21,5,0.6989700043360189,3,2
84,21,5,0.6989700043360189,1,4
85,21,4,0.6020599913279624,2,2
86,21,1,0.0,0,1
87,21,4,0.6020599913279624,2,2
88,21,3,0.47712125471966244,3,0
89,21,2,0.3010299956639812,1,1
90,21,2,0.3010299956639812,1,1
91,21,3,0.47712125471966244,1,2
92,21,28,1.4471580313422192,6,22
93,21,31,1.4913616938342726,5,26
94,21,33,1.5185139398778875,8,25
95,21,41,1.6127838567197355,16,25
96,21,17,1.2304489213782739,6,11
97,21,12,1.0791812460476249,6,6
98,21,1,0.0,0,1
99,21,4,0.6020599913279624,0,4
0,22,7,0.8450980400142568,0,7
1,22,2,0.3010299956639812,0,2
2,22,33,1.5185139398778875,13,20
3,22,31,1.4913616938342726,11,20
4,22,38,1.5797835966168101,12,26
5,22,26,1.414973347970818,10,16
6,22,14,1.146128035678238,5,9
7,22,18,1.255272505103306,10,8
9,22,2,0.3010299956639812,0,2
10,22,3,0.47712125471966244,1,2
12,22,2,0.3010299956639812,1,1
13,22,3,0.47712125471966244,1,2
14,22,2,0.3010299956639812,1,1
15,22,6,0.7781512503836436,2,4
16,22,6,0.7781512503836436,3,3
17,22,2,0.3010299956639812,0,2
18,22,6,0.7781512503836436,3,3
19,22,8,0.9030899869919435,3,5
20,22,6,0.7781512503836436,1,5
21,22,4,0.6020599913279624,3,1
22,22,3,0.47712125471966244,2,1
23,22,7,0.8450980400142568,2,5
24,22,5,0.6989700043360189,1,4
25,22,8,0.9030899869919435,2,6
26,22,5,0.6989700043360189,3,2
27,22,11,1.0413926851582251,1,10
28,22,11,1.0413926851582251,3,8
29,22,3,0.47712125471966244,1,2
30,22,5,0.6989700043360189,1,4
31,22,13,1.1139433523068367,2,11
32,22,14,1.146128035678238,8,6
33,22,7,0.8450980400142568,1,6
34,22,15,1.1760912590556813,4,11
35,22,11,1.0413926851582251,4,7
36,22,15,1.1760912590556813,4,11
37,22,11,1.0413926851582251,4,7
38,22,24,1.380211241711606,8,16
39,22,22,1.3424226808222062,11,11
40,22,35,1.5440680443502757,10,25
41,22,31,1.4913616938342726,9,22
42,22,48,1.6812412373755872,17,31
43,22,48,1.6812412373755872,17,31
44,22,45,1.6532125137753437,17,28
45,22,39,1.591064607026499,11,28
46,22,51,1.7075701760979363,24,27
47,22,49,1.6901960800285136,20,29
48,22,88,1.9444826721501687,33,55
49,22,84,1.9242792860618816,36,48
50,22,70,1.845098040014257,31,39
51,22,88,1.9444826721501687,34,54
52,22,44,1.6434526764861874,10,34
53,22,68,1.8325089127062364,24,44
54,22,37,1.568201724066995,10,27
55,22,43,1.6334684555795864,15,28
56,22,53,1.724275869600789,29,24
57,22,52,1.7160033436347992,23,29
58,22,58,1.7634279935629373,19,39
59,22,41,1.6127838567197355,12,29
60,22,31,1.4913616938342726,12,19
61,22,21,1.3222192947339193,7,14
62,22,22,1.3424226808222062,4,18
63,22,9,0.9542425094393249,3,6
64,22,23,1.3617278360175928,7,16
65,22,18,1.255272505103306,5,13
66,22,19,1.2787536009528289,7,12
67,22,5,0.6989700043360189,2,3
68,22,9,0.9542425094393249,1,8
69,22,15,1.1760912590556813,4,11
70,22,7,0.8450980400142568,3,4
71,22,9,0.9542425094393249,3,6
72,22,6,0.7781512503836436,1,5
73,22,8,0.9030899869919435,2,6
74,22,6,0.7781512503836436,2,4
75,22,10,1.0,4,6
76,22,5,0.6989700043360189,2,3
77,22,8,0.9030899869919435,3,5
78,22,9,0.9542425094393249,1,8
79,22,5,0.6989700043360189,0,5
80,22,6,0.7781512503836436,1,5
81,22,6,0.7781512503836436,4,2
82,22,2,0.3010299956639812,1,1
83,22,4,0.6020599913279624,1,3
85,22,3,0.47712125471966244,2,1
86,22,3,0.47712125471966244,0,3
87,22,6,0.7781512503836436,4,2
88,22,3,0.47712125471966244,1,2
89,22,2,0.3010299956639812,2,0
90,22,3,0.47712125471966244,2,1
91,22,3,0.47712125471966244,0,3
92,22,39,1.591064607026499,13,26
93,22,26,1.414973347970818,7,19
94,22,37,1.568201724066995,13,24
95,22,31,1.4913616938342726,13,18
96,22,10,1.0,4,6
97,22,15,1.1760912590556813,6,9
99,22,2,0.3010299956639812,1,1
0,23,5,0.6989700043360189,3,2
1,23,2,0.3010299956639812,2,0
2,23,22,1.3424226808222062,10,12
3,23,16,1.2041199826559248,3,13
4,23,34,1.5314789170422551,12,22
5,23,42,1.6232492903979006,16,26
6,23,21,1.3222192947339193,5,16
7,23,15,1.1760912590556813,5,10
8,23,1,0.0,1,0
9,23,3,0.47712125471966244,3,0
10,23,5,0.6989700043360189,1,4
12,23,7,0.8450980400142568,3,4
13,23,2,0.3010299956639812,0,2
14,23,2,0.3010299956639812,0,2
15,23,4,0.6020599913279624,2,2
16,23,2,0.3010299956639812,0,2
17,23,4,0.6020599913279624,1,3
18,23,10,1.0,4,6
20,23,8,0.9030899869919435,3,5
21,23,10,1.0,4,6
22,23,4,0.6020599913279624,0,4
23,23,7,0.8450980400142568,4,3
24,23,2,0.3010299956639812,0,2
25,23,3,0.47712125471966244,1,2
26,23,8,0.9030899869919435,3,5
27,23,9,0.9542425094393249,1,8
28,23,11,1.0413926851582251,2,9
29,23,11,1.0413926851582251,4,7
30,23,14,1.146128035678238,5,9
31,23,4,0.6020599913279624,1,3
32,23,10,1.0,2,8
33,23,16,1.2041199826559248,7,9
34,23,14,1.146128035678238,8,6
35,23,11,1.0413926851582251,4,7
36,23,16,1.2041199826559248,7,9
37,23,23,1.3617278360175928,8,15
38,23,25,1.3979400086720377,5,20
39,23,21,1.3222192947339193,7,14
40,23,35,1.5440680443502757,17,18
41,23,33,1.5185139398778875,11,22
42,23,45,1.6532125137753437,13,32
43,23,49,1.6901960800285136,19,30
44,23,38,1.5797835966168101,16,22
45,23,50,1.6989700043360187,24,26
46,23,54,1.7323937598229686,24,30
47,23,67,1.8260748027008264,27,40
48,23,80,1.9030899869919435,25,55
49,23,88,1.9444826721501687,40,48
50,23,89,1.9493900066449128,30,59
51,23,83,1.919078092376074,43,40
52,23,58,1.7634279935629373,19,39
53,23,64,1.806179973983887,21,43
54,23,39,1.591064607026499,11,28
55,23,50,1.6989700043360187,23,27
56,23,50,1.6989700043360187,17,33
57,23,61,1.7853298350107671,23,38
58,23,34,1.5314789170422551,10,24
59,23,30,1.4771212547196624,12,18
60,23,34,1.5314789170422551,13,21
61,23,31,1.4913616938342726,16,15
62,23,16,1.2041199826559248,5,11
63,23,13,1.1139433523068367,4,9
64,23,16,1.2041199826559248,7,9
65,23,26,1.414973347970818,7,19
66,23,13,1.1139433523068367,3,10
67,23,15,1.1760912590556813,5,10
68,23,4,0.6020599913279624,4,0
69,23,9,0.9542425094393249,2,7
70,23,9,0.9542425094393249,4,5
71,23,5,0.6989700043360189,1,4
72,23,10,1.0,3,7
73,23,8,0.9030899869919435,3,5
74,23,5,0.6989700043360189,2,3
75,23,5,0.6989700043360189,1,4
76,23,3,0.47712125471966244,2,1
77,23,3,0.47712125471966244,0,3
78,23,5,0.6989700043360189,1,4
79,23,4,0.6020599913279624,2,2
80,23,3,0.47712125471966244,1,2
81,23,7,0.8450980400142568,3,4
83,23,8,0.9030899869919435,3,5
84,23,5,0.6989700043360189,1,4
85,23,6,0.7781512503836436,2,4
86,23,3,0.47712125471966244,3,0
87,23,4,0.6020599913279624,3,1
88,23,3,0.47712125471966244,1,2
89,23,2,0.3010299956639812,0,2
90,23,2,0.3010299956639812,1,1
92,23,27,1.4313637641589874,11,16
93,23,40,1.6020599913279623,18,22
94,23,44,1.6434526764861874,15,29
95,23,41,1.6127838567197355,10,31
96,23,14,1.146128035678238,5,9
97,23,13,1.1139433523068367,6,7
98,23,1,0.0,0,1
0,24,4,0.6020599913279624,1,3
1,24,1,0.0,1,0
2,24,24,1.380211241711606,7,17
3,24,26,1.414973347970818,7,19
4,24,48,1.6812412373755872,19,29
5,24,44,1.6434526764861874,11,33
6,24,26,1.414973347970818,10,16
7,24,8,0.9030899869919435,5,3
8,24,5,0.6989700043360189,2,3
9,24,5,0.6989700043360189,2,3
10,24,3,0.47712125471966244,0,3
11,24,1,0.0,0,1
12,24,3,0.47712125471966244,1,2
13,24,5,0.6989700043360189,1,4
14,24,5,0.6989700043360189,0,5
15,24,1,0.0,1,0
16,24,3,0.47712125471966244,2,1
17,24,4,0.6020599913279624,3,1
18,24,7,0.8450980400142568,2,5
19,24,2,0.3010299956639812,1,1
20,24,4,0.6020599913279624,2,2
21,24,6,0.7781512503836436,4,2
22,24,8,0.9030899869919435,2,6
23,24,3,0.47712125471966244,0,3
24,24,5,0.6989700043360189,0,5
25,24,6,0.7781512503836436,2,4
26,24,6,0.7781512503836436,2,4
27,24,9,0.9542425094393249,2,7
28,24,13,1.1139433523068367,4,9
30,24,10,1.0,4,6
31,24,5,0.6989700043360189,2,3
32,24,14,1.146128035678238,5,9
33,24,14,1.146128035678238,6,8
34,24,22,1.3424226808222062,5,17
35,24,8,0.9030899869919435,2,6
36,24,10,1.0,7,3
37,24,18,1.255272505103306,8,10
38,24,20,1.3010299956639813,6,14
39,24,17,1.2304489213782739,3,14
40,24,30,1.4771212547196624,7,23
41,24,34,1.5314789170422551,10,24
42,24,40,1.6020599913279623,8,32
43,24,40,1.6020599913279623,17,23
44,24,40,1.6020599913279623,11,29
45,24,49,1.6901960800285136,20,29
46,24,47,1.6720978579357175,22,25
47,24,50,1.6989700043360187,23,27
48,24,64,1.806179973983887,27,37
49,24,91,1.9590413923210936,26,65
50,24,73,1.863322860120456,30,43
51,24,79,1.8976270912904414,31,48
52,24,51,1.7075701760979363,17,34
53,24,57,1.7558748556724915,21,36
54,24,40,1.6020599913279623,16,24
55,24,35,1.5440680443502757,17,18
56,24,45,1.6532125137753437,14,31
57,24,40,1.6020599913279623,7,33
58,24,39,1.591064607026499,12,27
59,24,31,1.4913616938342726,10,21
60,24,23,1.3617278360175928,3,20
61,24,21,1.3222192947339193,7,14
62,24,10,1.0,2,8
63,24,20,1.3010299956639813,8,12
64,24,12,1.0791812460476249,2,10
65,24,14,1.146128035678238,6,8
66,24,9,0.9542425094393249,6,3
67,24,13,1.1139433523068367,4,9
68,24,9,0.9542425094393249,3,6
69,24,9,0.9542425094393249,2,7
70,24,10,1.0,3,7
71,24,2,0.3010299956639812,2,0
72,24,6,0.7781512503836436,1,5
73,24,11,1.0413926851582251,7,4
74,24,5,0.6989700043360189,1,4
75,24,7,0.8450980400142568,6,1
76,24,8,0.9030899869919435,0,8
77,24,6,0.7781512503836436,4,2
78,24,4,0.6020599913279624,1,3
79,24,2,0.3010299956639812,0,2
80,24,8,0.9030899869919435,1,7
81,24,8,0.9030899869919435,4,4
82,24,5,0.6989700043360189,0,5
83,24,4,0.6020599913279624,1,3
84,24,1,0.0,0,1
85,24,5,0.6989700043360189,2,3
86,24,1,0.0,0,1
87,24,1,0.0,0,1
88,24,3,0.47712125471966244,0,3
90,24,2,0.3010299956639812,1,1
91,24,3,0.47712125471966244,1,2
92,24,28,1.4471580313422192,9,19
93,24,37,1.568201724066995,14,23
94,24,38,1.5797835966168101,9,29
95,24,47,1.6720978579357175,10,37
96,24,9,0.9542425094393249,4,5
97,24,11,1.0413926851582251,1,10
99,24,1,0.0,1,0
0,25,3,0.47712125471966244,0,3
1,25,2,0.3010299956639812,0,2
2,25,18,1.255272505103306,8,10
3,25,20,1.3010299956639813,8,12
4,25,40,1.6020599913279623,13,27
5,25,47,1.6720978579357175,14,33
6,25,19,1.2787536009528289,6,13
7,25,14,1.146128035678238,5,9
8,25,4,0.6020599913279624,2,2
9,25,6,0.7781512503836436,2,4
13,25,2,0.3010299956639812,0,2
14,25,1,0.0,0,1
15,25,3,0.47712125471966244,3,0
16,25,7,0.8450980400142568,3,4
17,25,2,0.3010299956639812,1,1
18,25,4,0.6020599913279624,3,1
19,25,5,0.6989700043360189,2,3
20,25,7,0.8450980400142568,2,5
21,25,10,1.0,1,9
22,25,2,0.3010299956639812,1,1
23,25,4,0.6020599913279624,2,2
24,25,6,0.7781512503836436,1,5
25,25,7,0.8450980400142568,4,3
26,25,7,0.8450980400142568,0,7
27,25,10,1.0,3,7
28,25,7,0.8450980400142568,1,6
29,25,12,1.0791812460476249,1,11
30,25,9,0.9542425094393249,4,5
31,25,20,1.3010299956639813,6,14
32,25,10,1.0,1,9
33,25,6,0.7781512503836436,2,4
34,25,10,1.0,7,3
35,25,7,0.8450980400142568,2,5
36,25,17,1.2304489213782739,7,10
37,25,9,0.9542425094393249,1,8
38,25,26,1.414973347970818,11,15
39,25,20,1.3010299956639813,8,12
40,25,35,1.5440680443502757,17,18
41,25,46,1.662757831681574,17,29
42,25,36,1.5563025007672873,14,22
43,25,41,1.6127838567197355,13,28
44,25,56,1.7481880270062005,20,36
45,25,42,1.6232492903979006,14,28
46,25,60,1.7781512503836436,28,32
47,25,54,1.7323937598229686,28,26
48,25,78,1.8920946026904804,29,49
49,25,93,1.968482948553935,35,58
50,25,86,1.9344984512435677,34,52
51,25,84,1.9242792860618816,31,53
52,25,46,1.662757831681574,22,24
53,25,44,1.6434526764861874,18,26
54,25,33,1.5185139398778875,19,14
55,25,39,1.591064607026499,13,26
56,25,45,1.6532125137753437,16,29
57,25,34,1.5314789170422551,14,20
58,25,27,1.4313637641589874,9,18
59,25,33,1.5185139398778875,12,21
60,25,30,1.4771212547196624,14,16
61,25,26,1.414973347970818,11,15
62,25,13,1.1139433523068367,4,9
63,25,18,1.255272505103306,7,11
64,25,10,1.0,2,8
65,25,8,0.9030899869919435,3,5
66,25,8,0.9030899869919435,1,7
67,25,11,1.0413926851582251,3,8
68,25,4,0.6020599913279624,2,2
69,25,7,0.8450980400142568,3,4
70,25,10,1.0,3,7
71,25,5,0.6989700043360189,1,4
72,25,11,1.0413926851582251,5,6
73,25,7,0.8450980400142568,3,4
74,25,8,0.9030899869919435,3,5
75,25,5,0.6989700043360189,1,4
76,25,5,0.6989700043360189,2,3
77,25,6,0.7781512503836436,3,3
78,25,4,0.6020599913279624,1,3
79,25,6,0.7781512503836436,2,4
80,25,2,0.3010299956639812,1,1
81,25,4,0.6020599913279624,2,2
82,25,2,0.3010299956639812,0,2
83,25,3,0.47712125471966244,0,3
84,25,2,0.3010299956639812,1,1
85,25,1,0.0,0,1
86,25,5,0.6989700043360189,1,4
87,25,2,0.3010299956639812,0,2
88,25,1,0.0,0,1
90,25,8,0.9030899869919435,2,6
91,25,2,0.3010299956639812,1,1
92,25,36,1.5563025007672873,13,23
93,25,42,1.6232492903979006,13,29
94,25,48,1.6812412373755872,15,33
95,25,36,1.5563025007672873,12,24
96,25,4,0.6020599913279624,0,4
97,25,6,0.7781512503836436,3,3
98,25,2,0.3010299956639812,1,1
99,25,1,0.0,0,1
1,26,2,0.3010299956639812,1,1
2,26,20,1.3010299956639813,8,12
3,26,21,1.3222192947339193,5,16
4,26,42,1.6232492903979006,16,26
5,26,37,1.568201724066995,11,26
6,26,26,1.414973347970818,10,16
7,26,29,1.462397997898956,10,19
8,26,8,0.9030899869919435,4,4
9,26,7,0.8450980400142568,2,5
10,26,1,0.0,1,0
11,26,2,0.3010299956639812,1,1
12,26,5,0.6989700043360189,3,2
13,26,2,0.3010299956639812,0,2
14,26,1,0.0,0,1
15,26,1,0.0,0,1
16,26,2,0.3010299956639812,0,2
17,26,6,0.7781512503836436,3,3
18,26,4,0.6020599913279624,2,2
19,26,4,0.6020599913279624,0,4
20,26,5,0.6989700043360189,2,3
21,26,4,0.6020599913279624,2,2
22,26,7,0.8450980400142568,3,4
23,26,8,0.9030899869919435,4,4
24,26,10,1.0,4,6
25,26,6,0.7781512503836436,2,4
26,26,7,0.8450980400142568,1,6
27,26,3,0.47712125471966244,1,2
28,26,9,0.9542425094393249,2,7
29,26,14,1.146128035678238,6,8
30,26,15,1.1760912590556813,3,12
31,26,6,0.7781512503836436,1,5
32,26,12,1.0791812460476249,2,10
33,26,12,1.0791812460476249,6,6
34,26,18,1.255272505103306,6,12
35,26,8,0.9030899869919435,2,6
36,26,10,1.0,3,7
37,26,24,1.380211241711606,6,18
38,26,20,1.3010299956639813,6,14
39,26,25,1.3979400086720377,11,14
40,26,35,1.5440680443502757,14,21
41,26,21,1.3222192947339193,11,10
42,26,48,1.6812412373755872,19,29
43,26,46,1.662757831681574,13,33
44,26,34,1.5314789170422551,15,19
45,26,41,1.6127838567197355,16,25
46,26,40,1.6020599913279623,18,22
47,26,38,1.5797835966168101,15,23
48,26,60,1.7781512503836436,20,40
49,26,80,1.9030899869919435,33,47
50,26,77,1.8864907251724818,32,45
51,26,81,1.9084850188786497,35,46
52,26,40,1.6020599913279623,18,22
53,26,44,1.6434526764861874,20,24
54,26,29,1.462397997898956,10,19
55,26,40,1.6020599913279623,11,29
56,26,35,1.5440680443502757,12,23
57,26,40,1.6020599913279623,14,26
58,26,31,1.4913616938342726,12,19
59,26,31,1.4913616938342726,15,16
60,26,21,1.3222192947339193,6,15
61,26,21,1.3222192947339193,8,13
62,26,12,1.0791812460476249,7,5
63,26,17,1.2304489213782739,8,9
64,26,7,0.8450980400142568,4,3
65,26,13,1.1139433523068367,4,9
66,26,9,0.9542425094393249,3,6
67,26,10,1.0,3,7
68,26,6,0.7781512503836436,3,3
69,26,11,1.0413926851582251,4,7
70,26,8,0.9030899869919435,1,7
71,26,17,1.2304489213782739,8,9
72,26,8,0.9030899869919435,1,7
73,26,7,0.8450980400142568,2,5
74,26,6,0.7781512503836436,0,6
75,26,9,0.9542425094393249,4,5
76,26,7,0.8450980400142568,3,4
77,26,6,0.7781512503836436,2,4
78,26,4,0.6020599913279624,2,2
79,26,3,0.47712125471966244,1,2
80,26,5,0.6989700043360189,1,4
81,26,6,0.7781512503836436,3,3
82,26,5,0.6989700043360189,1,4
83,26,2,0.3010299956639812,0,2
84,26,6,0.7781512503836436,2,4
85,26,4,0.6020599913279624,0,4
86,26,1,0.0,0,1
87,26,4,0.6020599913279624,1,3
88,26,3,0.47712125471966244,1,2
89,26,1,0.0,0,1
90,26,4,0.6020599913279624,1,3
91,26,6,0.7781512503836436,2,4
92,26,37,1.568201724066995,16,21
93,26,37,1.568201724066995,12,25
94,26,34,1.5314789170422551,15,19
95,26,34,1.5314789170422551,9,25
96,26,8,0.9030899869919435,4,4
97,26,6,0.7781512503836436,1,5
0,27,3,0.47712125471966244,1,2
2,27,19,1.2787536009528289,7,12
3,27,21,1.3222192947339193,4,17
4,27,45,1.6532125137753437,17,28
5,27,39,1.591064607026499,19,20
6,27,38,1.5797835966168101,14,24
7,27,34,1.5314789170422551,15,19
8,27,8,0.9030899869919435,3,5
9,27,6,0.7781512503836436,1,5
10,27,1,0.0,0,1
11,27,3,0.47712125471966244,1,2
12,27,1,0.0,0,1
13,27,1,0.0,1,0
14,27,2,0.3010299956639812,0,2
16,27,6,0.7781512503836436,2,4
17,27,2,0.3010299956639812,0,2
18,27,2,0.3010299956639812,0,2
19,27,5,0.6989700043360189,2,3
20,27,2,0.3010299956639812,1,1
21,27,8,0.9030899869919435,5,3
22,27,6,0.7781512503836436,2,4
23,27,10,1.0,3,7
24,27,8,0.9030899869919435,2,6
25,27,7,0.8450980400142568,0,7
26,27,9,0.9542425094393249,2,7
27,27,5,0.6989700043360189,1,4
28,27,7,0.8450980400142568,1,6
29,27,8,0.9030899869919435,4,4
30,27,5,0.6989700043360189,2,3
31,27,6,0.7781512503836436,2,4
32,27,9,0.9542425094393249,3,6
33,27,14,1.146128035678238,5,9
34,27,15,1.1760912590556813,5,10
35,27,10,1.0,5,5
36,27,15,1.1760912590556813,4,11
37,27,19,1.2787536009528289,6,13
38,27,17,1.2304489213782739,5,12
39,27,40,1.6020599913279623,11,29
40,27,30,1.4771212547196624,14,16
41,27,28,1.4471580313422192,12,16
42,27,34,1.5314789170422551,12,22
43,27,40,1.6020599913279623,14,26
44,27,33,1.5185139398778875,9,24
45,27,40,1.6020599913279623,13,27
46,27,33,1.5185139398778875,14,19
47,27,52,1.7160033436347992,22,30
48,27,60,1.7781512503836436,29,31
49,27,59,1.7708520116421442,23,36
50,27,58,1.7634279935629373,17,41
51,27,70,1.845098040014257,33,37
52,27,32,1.505149978319906,5,27
53,27,42,1.6232492903979006,14,28
54,27,46,1.662757831681574,17,29
55,27,38,1.5797835966168101,16,22
56,27,45,1.6532125137753437,10,35
57,27,30,1.4771212547196624,12,18
58,27,34,1.5314789170422551,15,19
59,27,26,1.414973347970818,13,13
60,27,17,1.2304489213782739,8,9
61,27,22,1.3424226808222062,10,12
62,27,16,1.2041199826559248,2,14
63,27,14,1.146128035678238,7,7
64,27,13,1.1139433523068367,5,8
65,27,21,1.3222192947339193,9,12
66,27,14,1.146128035678238,3,11
67,27,5,0.6989700043360189,0,5
68,27,5,0.6989700043360189,0,5
69,27,5,0.6989700043360189,3,2
70,27,7,0.8450980400142568,3,4
71,27,10,1.0,4,6
72,27,5,0.6989700043360189,3,2
73,27,10,1.0,5,5
74,27,8,0.9030899869919435,4,4
75,27,9,0.9542425094393249,1,8
76,27,8,0.9030899869919435,4,4
77,27,11,1.0413926851582251,4,7
78,27,7,0.8450980400142568,1,6
79,27,3,0.47712125471966244,1,2
80,27,4,0.6020599913279624,3,1
81,27,5,0.6989700043360189,1,4
82,27,5,0.6989700043360189,3,2
84,27,6,0.7781512503836436,0,6
85,27,4,0.6020599913279624,0,4
86,27,1,0.0,1,0
87,27,1,0.0,1,0
88,27,1,0.0,1,0
90,27,7,0.8450980400142568,2,5
91,27,4,0.6020599913279624,2,2
92,27,46,1.662757831681574,22,24
93,27,37,1.568201724066995,14,23
94,27,51,1.7075701760979363,17,34
95,27,44,1.6434526764861874,12,32
96,27,5,0.6989700043360189,0,5
97,27,6,0.7781512503836436,0,6
1,28,1,0.0,0,1
2,28,12,1.0791812460476249,2,10
3,28,7,0.8450980400142568,4,3
4,28,32,1.505149978319906,9,23
5,28,37,1.568201724066995,11,26
6,28,33,1.5185139398778875,11,22
7,28,36,1.5563025007672873,9,27
8,28,11,1.0413926851582251,2,9
9,28,10,1.0,5,5
10,28,2,0.3010299956639812,0,2
11,28,1,0.0,0,1
12,28,2,0.3010299956639812,1,1
13,28,1,0.0,0,1
14,28,2,0.3010299956639812,2,0
15,28,3,0.47712125471966244,2,1
16,28,5,0.6989700043360189,2,3
17,28,4,0.6020599913279624,0,4
18,28,3,0.47712125471966244,1,2
19,28,5,0.6989700043360189,1,4
20,28,5,0.6989700043360189,2,3
21,28,9,0.9542425094393249,3,6
22,28,6,0.7781512503836436,3,3
23,28,5,0.6989700043360189,1,4
24,28,7,0.8450980400142568,3,4
25,28,7,0.8450980400142568,4,3
26,28,7,0.8450980400142568,1,6
27,28,4,0.6020599913279624,1,3
28,28,7,0.8450980400142568,1,6
29,28,9,0.9542425094393249,3,6
30,28,5,0.6989700043360189,1,4
31,28,13,1.1139433523068367,4,9
32,28,10,1.0,2,8
33,28,7,0.8450980400142568,5,2
34,28,13,1.1139433523068367,4,9
35,28,13,1.1139433523068367,5,8
36,28,8,0.9030899869919435,2,6
37,28,8,0.9030899869919435,2,6
38,28,21,1.3222192947339193,10,11
39,28,20,1.3010299956639813,7,13
40,28,27,1.4313637641589874,13,14
41,28,23,1.3617278360175928,4,19
42,28,32,1.505149978319906,10,22
43,28,42,1.6232492903979006,11,31
44,28,38,1.5797835966168101,15,23
45,28,33,1.5185139398778875,15,18
46,28,37,1.568201724066995,16,21
47,28,48,1.6812412373755872,19,29
48,28,56,1.7481880270062005,22,34
49,28,59,1.7708520116421442,22,37
50,28,59,1.7708520116421442,18,41
51,28,66,1.8195439355418688,26,40
52,28,30,1.4771212547196624,11,19
53,28,38,1.5797835966168101,20,18
54,28,32,1.505149978319906,15,17
55,28,32,1.505149978319906,13,19
56,28,40,1.6020599913279623,12,28
57,28,44,1.6434526764861874,15,29
58,28,28,1.4471580313422192,9,19
59,28,27,1.4313637641589874,12,15
60,28,20,1.3010299956639813,10,10
61,28,15,1.1760912590556813,3,12
62,28,22,1.3424226808222062,10,12
63,28,16,1.2041199826559248,5,11
64,28,15,1.1760912590556813,3,12
65,28,11,1.0413926851582251,7,4
66,28,11,1.0413926851582251,4,7
67,28,4,0.6020599913279624,2,2
68,28,9,0.9542425094393249,3,6
69,28,13,1.1139433523068367,8,5
70,28,8,0.9030899869919435,3,5
71,28,10,1.0,4,6
72,28,9,0.9542425094393249,1,8
73,28,7,0.8450980400142568,1,6
74,28,5,0.6989700043360189,2,3
75,28,5,0.6989700043360189,2,3
76,28,5,0.6989700043360189,3,2
77,28,7,0.8450980400142568,4,3
78,28,5,0.6989700043360189,3,2
79,28,4,0.6020599913279624,3,1
80,28,2,0.3010299956639812,1,1
81,28,2,0.3010299956639812,1,1
82,28,2,0.3010299956639812,1,1
83,28,5,0.6989700043360189,1,4
84,28,1,0.0,0,1
85,28,7,0.8450980400142568,2,5
87,28,3,0.47712125471966244,0,3
88,28,1,0.0,0,1
89,28,2,0.3010299956639812,0,2
90,28,9,0.9542425094393249,2,7
91,28,14,1.146128035678238,5,9
92,28,49,1.6901960800285136,21,28
93,28,47,1.6720978579357175,17,30
94,28,27,1.4313637641589874,8,19
95,28,38,1.5797835966168101,13,25
96,28,1,0.0,1,0
97,28,4,0.6020599913279624,1,3
1,29,2,0.3010299956639812,0,2
2,29,5,0.6989700043360189,2,3
3,29,13,1.1139433523068367,4,9
4,29,27,1.4313637641589874,7,20
5,29,31,1.4913616938342726,8,23
6,29,29,1.462397997898956,14,15
7,29,32,1.505149978319906,14,18
8,29,17,1.2304489213782739,5,12
9,29,16,1.2041199826559248,3,13
10,29,3,0.47712125471966244,0,3
11,29,5,0.6989700043360189,2,3
13,29,1,0.0,0,1
14,29,1,0.0,0,1
15,29,3,0.47712125471966244,0,3
16,29,3,0.47712125471966244,1,2
17,29,3,0.47712125471966244,1,2
18,29,4,0.6020599913279624,2,2
19,29,3,0.47712125471966244,2,1
20,29,5,0.6989700043360189,2,3
21,29,9,0.9542425094393249,1,8
22,29,2,0.3010299956639812,0,2
23,29,5,0.6989700043360189,1,4
24,29,6,0.7781512503836436,2,4
25,29,11,1.0413926851582251,2,9
26,29,5,0.6989700043360189,4,1
27,29,4,0.6020599913279624,1,3
28,29,3,0.47712125471966244,2,1
29,29,8,0.9030899869919435,3,5
30,29,11,1.0413926851582251,7,4
31,29,8,0.9030899869919435,2,6
32,29,15,1.1760912590556813,3,12
33,29,4,0.6020599913279624,0,4
34,29,21,1.3222192947339193,5,16
35,29,13,1.1139433523068367,6,7
36,29,14,1.146128035678238,5,9
37,29,15,1.1760912590556813,7,8
38,29,18,1.255272505103306,4,14
39,29,18,1.255272505103306,5,13
40,29,31,1.4913616938342726,10,21
41,29,29,1.462397997898956,13,16
42,29,41,1.6127838567197355,13,28
43,29,41,1.6127838567197355,12,29
44,29,46,1.662757831681574,12,34
45,29,21,1.3222192947339193,8,13
46,29,33,1.5185139398778875,12,21
47,29,39,1.591064607026499,20,19
48,29,54,1.7323937598229686,27,27
49,29,44,1.6434526764861874,17,27
50,29,37,1.568201724066995,17,20
51,29,49,1.6901960800285136,13,36
52,29,35,1.5440680443502757,14,21
53,29,32,1.505149978319906,10,22
54,29,28,1.4471580313422192,10,18
55,29,42,1.6232492903979006,12,30
56,29,27,1.4313637641589874,10,17
57,29,32,1.505149978319906,8,24
58,29,28,1.4471580313422192,15,13
59,29,19,1.2787536009528289,8,11
60,29,17,1.2304489213782739,12,5
61,29,18,1.255272505103306,7,11
62,29,11,1.0413926851582251,5,6
63,29,14,1.146128035678238,3,11
64,29,13,1.1139433523068367,7,6
65,29,13,1.1139433523068367,4,9
66,29,8,0.9030899869919435,3,5
67,29,14,1.146128035678238,6,8
68,29,10,1.0,3,7
69,29,13,1.1139433523068367,3,10
70,29,9,0.9542425094393249,2,7
71,29,10,1.0,4,6
72,29,3,0.47712125471966244,1,2
73,29,6,0.7781512503836436,5,1
74,29,7,0.8450980400142568,2,5
75,29,5,0.6989700043360189,2,3
76,29,6,0.7781512503836436,4,2
77,29,9,0.9542425094393249,1,8
78,29,4,0.6020599913279624,1,3
79,29,5,0.6989700043360189,3,2
80,29,7,0.8450980400142568,3,4
81,29,5,0.6989700043360189,1,4
83,29,5,0.6989700043360189,1,4
84,29,3,0.47712125471966244,2,1
85,29,3,0.47712125471966244,2,1
86,29,3,0.47712125471966244,2,1
87,29,4,0.6020599913279624,0,4
88,29,3,0.47712125471966244,0,3
89,29,3,0.47712125471966244,0,3
90,29,25,1.3979400086720377,11,14
91,29,24,1.380211241711606,9,15
92,29,47,1.6720978579357175,16,31
93,29,25,1.3979400086720377,13,12
94,29,36,1.5563025007672873,11,25
95,29,41,1.6127838567197355,17,24
96,29,2,0.3010299956639812,2,0
97,29,3,0.47712125471966244,1,2
99,29,1,0.0,0,1
1,30,1,0.0,0,1
2,30,7,0.8450980400142568,3,4
3,30,8,0.9030899869919435,2,6
4,30,35,1.5440680443502757,15,20
5,30,28,1.4471580313422192,13,15
6,30,43,1.6334684555795864,12,31
7,30,22,1.3424226808222062,9,13
8,30,14,1.146128035678238,8,6
9,30,22,1.3424226808222062,7,15
10,30,8,0.9030899869919435,2,6
11,30,8,0.9030899869919435,1,7
12,30,1,0.0,0,1
13,30,1,0.0,0,1
14,30,2,0.3010299956639812,1,1
15,30,2,0.3010299956639812,1,1
16,30,2,0.3010299956639812,1,1
17,30,1,0.0,1,0
18,30,5,0.6989700043360189,1,4
19,30,6,0.7781512503836436,2,4
20,30,6,0.7781512503836436,2,4
21,30,5,0.6989700043360189,2,3
22,30,7,0.8450980400142568,1,6
23,30,7,0.8450980400142568,2,5
24,30,5,0.6989700043360189,2,3
25,30,5,0.6989700043360189,2,3
26,30,8,0.9030899869919435,6,2
27,30,8,0.9030899869919435,2,6
28,30,5,0.6989700043360189,1,4
29,30,9,0.9542425094393249,4,5
30,30,10,1.0,4,6
31,30,9,0.9542425094393249,4,5
32,30,7,0.8450980400142568,2,5
33,30,12,1.0791812460476249,7,5
34,30,13,1.1139433523068367,5,8
35,30,5,0.6989700043360189,0,5
36,30,14,1.146128035678238,2,12
37,30,16,1.2041199826559248,10,6
38,30,14,1.146128035678238,6,8
39,30,19,1.2787536009528289,5,14
40,30,29,1.462397997898956,13,16
41,30,27,1.4313637641589874,11,16
42,30,32,1.505149978319906,9,23
43,30,26,1.414973347970818,8,18
44,30,30,1.4771212547196624,16,14
45,30,24,1.380211241711606,9,15
46,30,30,1.4771212547196624,11,19
47,30,29,1.462397997898956,11,18
48,30,41,1.6127838567197355,14,27
49,30,47,1.6720978579357175,22,25
50,30,44,1.6434526764861874,16,28
51,30,46,1.662757831681574,15,31
52,30,36,1.5563025007672873,15,21
53,30,34,1.5314789170422551,12,22
54,30,24,1.380211241711606,10,14
55,30,19,1.2787536009528289,11,8
56,30,29,1.462397997898956,12,17
57,30,32,1.505149978319906,11,21
58,30,17,1.2304489213782739,11,6
59,30,28,1.4471580313422192,11,17
60,30,11,1.0413926851582251,7,4
61,30,16,1.2041199826559248,9,7
62,30,13,1.1139433523068367,4,9
63,30,8,0.9030899869919435,2,6
64,30,15,1.1760912590556813,1,14
65,30,7,0.8450980400142568,2,5
66,30,4,0.6020599913279624,1,3
67,30,14,1.146128035678238,8,6
68,30,10,1.0,7,3
69,30,13,1.1139433523068367,6,7
70,30,6,0.7781512503836436,2,4
71,30,5,0.6989700043360189,2,3
72,30,4,0.6020599913279624,0,4
73,30,6,0.7781512503836436,2,4
74,30,5,0.6989700043360189,3,2
75,30,8,0.9030899869919435,1,7
76,30,3,0.47712125471966244,0,3
77,30,5,0.6989700043360189,0,5
78,30,4,0.6020599913279624,1,3
79,30,5,0.6989700043360189,1,4
80,30,6,0.7781512503836436,3,3
81,30,6,0.7781512503836436,2,4
82,30,4,0.6020599913279624,0,4
83,30,2,0.3010299956639812,0,2
84,30,2,0.3010299956639812,1,1
85,30,5,0.6989700043360189,3,2
86,30,2,0.3010299956639812,0,2
87,30,4,0.6020599913279624,3,1
88,30,7,0.8450980400142568,2,5
89,30,4,0.6020599913279624,1,3
90,30,25,1.3979400086720377,9,16
91,30,22,1.3424226808222062,5,17
92,30,46,1.662757831681574,9,37
93,30,53,1.724275869600789,20,33
94,30,33,1.5185139398778875,8,25
95,30,34,1.5314789170422551,16,18
96,30,3,0.47712125471966244,1,2
97,30,4,0.6020599913279624,2,2
2,31,6,0.7781512503836436,3,3
3,31,7,0.8450980400142568,4,3
4,31,20,1.3010299956639813,7,13
5,31,20,1.3010299956639813,7,13
6,31,43,1.6334684555795864,16,27
7,31,38,1.5797835966168101,8,30
8,31,24,1.380211241711606,7,17
9,31,33,1.5185139398778875,9,24
10,31,10,1.0,1,9
11,31,6,0.7781512503836436,1,5
12,31,1,0.0,0,1
13,31,3,0.47712125471966244,2,1
14,31,2,0.3010299956639812,1,1
15,31,3,0.47712125471966244,3,0
16,31,4,0.6020599913279624,2,2
17,31,3,0.47712125471966244,2,1
18,31,4,0.6020599913279624,2,2
19,31,3,0.47712125471966244,1,2
20,31,4,0.6020599913279624,2,2
21,31,6,0.7781512503836436,1,5
22,31,7,0.8450980400142568,1,6
23,31,8,0.9030899869919435,3,5
24,31,11,1.0413926851582251,3,8
25,31,10,1.0,3,7
26,31,12,1.0791812460476249,4,8
27,31,9,0.9542425094393249,4,5
28,31,9,0.9542425094393249,2,7
29,31,11,1.0413926851582251,3,8
30,31,8,0.9030899869919435,4,4
31,31,10,1.0,4,6
32,31,9,0.9542425094393249,2,7
33,31,8,0.9030899869919435,2,6
34,31,14,1.146128035678238,4,10
35,31,8,0.9030899869919435,3,5
36,31,11,1.0413926851582251,1,10
37,31,11,1.0413926851582251,3,8
38,31,12,1.0791812460476249,1,11
39,31,11,1.0413926851582251,1,10
40,31,25,1.3979400086720377,6,19
41,31,26,1.414973347970818,11,15
42,31,24,1.380211241711606,14,10
43,31,22,1.3424226808222062,10,12
44,31,22,1.3424226808222062,15,7
45,31,30,1.4771212547196624,12,18
46,31,24,1.380211241711606,10,14
47,31,29,1.462397997898956,10,19
48,31,41,1.6127838567197355,15,26
49,31,47,1.6720978579357175,15,32
50,31,53,1.724275869600789,22,31
51,31,37,1.568201724066995,9,28
52,31,20,1.3010299956639813,7,13
53,31,26,1.414973347970818,11,15
54,31,18,1.255272505103306,5,13
55,31,15,1.1760912590556813,6,9
56,31,36,1.5563025007672873,9,27
57,31,23,1.3617278360175928,7,16
58,31,23,1.3617278360175928,10,13
59,31,19,1.2787536009528289,8,11
60,31,22,1.3424226808222062,8,14
61,31,19,1.2787536009528289,6,13
62,31,13,1.1139433523068367,3,10
63,31,12,1.0791812460476249,1,11
64,31,12,1.0791812460476249,5,7
65,31,16,1.2041199826559248,7,9
66,31,14,1.146128035678238,7,7
67,31,10,1.0,1,9
68,31,6,0.7781512503836436,0,6
69,31,7,0.8450980400142568,3,4
70,31,6,0.7781512503836436,2,4
71,31,9,0.9542425094393249,3,6
72,31,7,0.8450980400142568,4,3
73,31,10,1.0,2,8
74,31,5,0.6989700043360189,1,4
75,31,12,1.0791812460476249,5,7
76,31,4,0.6020599913279624,2,2
77,31,7,0.8450980400142568,4,3
78,31,4,0.6020599913279624,3,1
79,31,7,0.8450980400142568,1,6
80,31,5,0.6989700043360189,0,5
81,31,2,0.3010299956639812,1,1
82,31,2,0.3010299956639812,0,2
83,31,6,0.7781512503836436,3,3
84,31,3,0.47712125471966244,0,3
85,31,1,0.0,0,1
86,31,4,0.6020599913279624,2,2
88,31,3,0.47712125471966244,1,2
89,31,3,0.47712125471966244,1,2
90,31,28,1.4471580313422192,13,15
91,31,23,1.3617278360175928,6,17
92,31,37,1.568201724066995,10,27
93,31,45,1.6532125137753437,14,31
94,31,20,1.3010299956639813,5,15
95,31,28,1.4471580313422192,9,19
96,31,2,0.3010299956639812,1,1
97,31,1,0.0,0,1
98,31,1,0.0,0,1
99,31,1,0.0,1,0
2,32,5,0.6989700043360189,2,3
3,32,3,0.47712125471966244,3,0
4,32,17,1.2304489213782739,6,11
5,32,20,1.3010299956639813,4,16
6,32,36,1.5563025007672873,15,21
7,32,38,1.5797835966168101,12,26
8,32,49,1.6901960800285136,17,32
9,32,29,1.462397997898956,7,22
10,32,14,1.146128035678238,3,11
11,32,10,1.0,5,5
12,32,3,0.47712125471966244,0,3
13,32,5,0.6989700043360189,0,5
14,32,2,0.3010299956639812,1,1
15,32,1,0.0,0,1
16,32,3,0.47712125471966244,1,2
17,32,2,0.3010299956639812,0,2
18,32,4,0.6020599913279624,2,2
19,32,4,0.6020599913279624,1,3
20,32,5,0.6989700043360189,3,2
21,32,7,0.8450980400142568,2,5
22,32,4,0.6020599913279624,0,4
23,32,4,0.6020599913279624,1,3
24,32,2,0.3010299956639812,2,0
25,32,5,0.6989700043360189,2,3
26,32,6,0.7781512503836436,2,4
27,32,11,1.0413926851582251,5,6
28,32,8,0.9030899869919435,3,5
29,32,9,0.9542425094393249,3,6
30,32,9,0.9542425094393249,5,4
31,32,15,1.1760912590556813,7,8
32,32,9,0.9542425094393249,3,6
33,32,13,1.1139433523068367,3,10
34,32,12,1.0791812460476249,0,12
35,32,11,1.0413926851582251,5,6
36,32,16,1.2041199826559248,7,9
37,32,13,1.1139433523068367,4,9
38,32,17,1.2304489213782739,6,11
39,32,16,1.2041199826559248,5,11
40,32,17,1.2304489213782739,7,10
41,32,19,1.2787536009528289,9,10
42,32,22,1.3424226808222062,11,11
43,32,29,1.462397997898956,9,20
44,32,24,1.380211241711606,7,17
45,32,18,1.255272505103306,10,8
46,32,21,1.3222192947339193,8,13
47,32,26,1.414973347970818,7,19
48,32,41,1.6127838567197355,18,23
49,32,45,1.6532125137753437,16,29
50,32,38,1.5797835966168101,14,24
51,32,40,1.6020599913279623,17,23
52,32,17,1.2304489213782739,9,8
53,32,17,1.2304489213782739,8,9
54,32,14,1.146128035678238,7,7
55,32,16,1.2041199826559248,6,10
56,32,20,1.3010299956639813,7,13
57,32,19,1.2787536009528289,3,16
58,32,32,1.505149978319906,14,18
59,32,16,1.2041199826559248,3,13
60,32,20,1.3010299956639813,4,16
61,32,17,1.2304489213782739,9,8
62,32,7,0.8450980400142568,4,3
63,32,16,1.2041199826559248,8,8
64,32,10,1.0,1,9
65,32,14,1.146128035678238,4,10
66,32,10,1.0,3,7
67,32,6,0.7781512503836436,2,4
68,32,9,0.9542425094393249,1,8
69,32,7,0.8450980400142568,3,4
70,32,10,1.0,5,5
71,32,10,1.0,3,7
72,32,9,0.9542425094393249,5,4
73,32,3,0.47712125471966244,0,3
74,32,7,0.8450980400142568,1,6
75,32,5,0.6989700043360189,1,4
76,32,6,0.7781512503836436,2,4
77,32,10,1.0,7,3
78,32,5,0.6989700043360189,2,3
79,32,7,0.8450980400142568,4,3
80,32,6,0.7781512503836436,0,6
81,32,5,0.6989700043360189,1,4
82,32,6,0.7781512503836436,4,2
83,32,3,0.47712125471966244,2,1
84,32,1,0.0,0,1
85,32,2,0.3010299956639812,1,1
86,32,8,0.9030899869919435,2,6
87,32,2,0.3010299956639812,1,1
88,32,16,1.2041199826559248,6,10
89,32,17,1.2304489213782739,6,11
90,32,28,1.4471580313422192,11,17
91,32,29,1.462397997898956,8,21
92,32,29,1.462397997898956,15,14
93,32,42,1.6232492903979006,18,24
94,32,23,1.3617278360175928,8,15
95,32,15,1.1760912590556813,2,13
96,32,2,0.3010299956639812,0,2
97,32,1,0.0,0,1
2,33,3,0.47712125471966244,2,1
3,33,3,0.47712125471966244,1,2
4,33,20,1.3010299956639813,6,14
5,33,19,1.2787536009528289,6,13
6,33,40,1.6020599913279623,13,27
7,33,38,1.5797835966168101,15,23
8,33,42,1.6232492903979006,15,27
9,33,38,1.5797835966168101,14,24
10,33,12,1.0791812460476249,2,10
11,33,15,1.1760912590556813,6,9
12,33,2,0.3010299956639812,1,1
13,33,6,0.7781512503836436,4,2
15,33,3,0.47712125471966244,1,2
16,33,1,0.0,0,1
17,33,2,0.3010299956639812,1,1
18,33,1,0.0,0,1
19,33,3,0.47712125471966244,1,2
20,33,2,0.3010299956639812,2,0
21,33,6,0.7781512503836436,4,2
22,33,13,1.1139433523068367,5,8
23,33,4,0.6020599913279624,1,3
24,33,8,0.9030899869919435,3,5
25,33,6,0.7781512503836436,1,5
26,33,7,0.8450980400142568,3,4
27,33,13,1.1139433523068367,1,12
28,33,4,0.6020599913279624,2,2
29,33,15,1.1760912590556813,5,10
30,33,10,1.0,4,6
31,33,8,0.9030899869919435,2,6
32,33,9,0.9542425094393249,4,5
33,33,7,0.8450980400142568,3,4
34,33,11,1.0413926851582251,4,7
35,33,16,1.2041199826559248,6,10
36,33,15,1.1760912590556813,2,13
37,33,11,1.0413926851582251,5,6
38,33,8,0.9030899869919435,2,6
39,33,12,1.0791812460476249,4,8
40,33,21,1.3222192947339193,4,17
41,33,15,1.1760912590556813,6,9
42,33,14,1.146128035678238,6,8
43,33,19,1.2787536009528289,7,12
44,33,17,1.2304489213782739,7,10
45,33,14,1.146128035678238,4,10
46,33,17,1.2304489213782739,6,11
47,33,14,1.146128035678238,4,10
48,33,28,1.4471580313422192,14,14
49,33,26,1.414973347970818,9,17
50,33,21,1.3222192947339193,6,15
51,33,26,1.414973347970818,11,15
52,33,19,1.2787536009528289,9,10
53,33,13,1.1139433523068367,4,9
54,33,22,1.3424226808222062,7,15
55,33,13,1.1139433523068367,4,9
56,33,22,1.3424226808222062,10,12
57,33,18,1.255272505103306,8,10
58,33,20,1.3010299956639813,10,10
59,33,15,1.1760912590556813,6,9
60,33,18,1.255272505103306,9,9
61,33,17,1.2304489213782739,5,12
62,33,14,1.146128035678238,3,11
63,33,14,1.146128035678238,6,8
64,33,11,1.0413926851582251,4,7
65,33,15,1.1760912590556813,5,10
66,33,8,0.9030899869919435,1,7
67,33,9,0.9542425094393249,4,5
68,33,14,1.146128035678238,1,13
69,33,9,0.9542425094393249,2,7
70,33,9,0.9542425094393249,4,5
71,33,12,1.0791812460476249,6,6
72,33,8,0.9030899869919435,2,6
73,33,10,1.0,3,7
74,33,9,0.9542425094393249,2,7
75,33,7,0.8450980400142568,2,5
76,33,6,0.7781512503836436,1,5
77,33,6,0.7781512503836436,1,5
78,33,4,0.6020599913279624,0,4
79,33,3,0.47712125471966244,1,2
80,33,5,0.6989700043360189,4,1
81,33,4,0.6020599913279624,0,4
82,33,1,0.0,0,1
83,33,4,0.6020599913279624,1,3
84,33,2,0.3010299956639812,0,2
85,33,3,0.47712125471966244,2,1
86,33,3,0.47712125471966244,2,1
87,33,1,0.0,0,1
88,33,10,1.0,4,6
89,33,18,1.255272505103306,6,12
90,33,33,1.5185139398778875,5,28
91,33,41,1.6127838567197355,13,28
92,33,49,1.6901960800285136,14,35
93,33,42,1.6232492903979006,10,32
94,33,13,1.1139433523068367,4,9
95,33,23,1.3617278360175928,8,15
96,33,1,0.0,0,1
1,34,1,0.0,0,1
2,34,4,0.6020599913279624,0,4
4,34,20,1.3010299956639813,9,11
5,34,15,1.1760912590556813,2,13
6,34,25,1.3979400086720377,6,19
7,34,32,1.505149978319906,11,21
8,34,33,1.5185139398778875,9,24
9,34,46,1.662757831681574,16,30
10,34,23,1.3617278360175928,7,16
11,34,25,1.3979400086720377,9,16
12,34,8,0.9030899869919435,4,4
13,34,14,1.146128035678238,7,7
14,34,4,0.6020599913279624,2,2
15,34,1,0.0,0,1
16,34,3,0.47712125471966244,2,1
17,34,3,0.47712125471966244,2,1
18,34,6,0.7781512503836436,2,4
19,34,2,0.3010299956639812,1,1
20,34,4,0.6020599913279624,1,3
21,34,11,1.0413926851582251,5,6
22,34,8,0.9030899869919435,2,6
23,34,5,0.6989700043360189,0,5
24,34,11,1.0413926851582251,3,8
25,34,9,0.9542425094393249,4,5
26,34,7,0.8450980400142568,2,5
27,34,13,1.1139433523068367,4,9
28,34,9,0.9542425094393249,3,6
29,34,9,0.9542425094393249,5,4
30,34,5,0.6989700043360189,2,3
31,34,8,0.9030899869919435,4,4
32,34,11,1.0413926851582251,2,9
33,34,11,1.0413926851582251,3,8
34,34,10,1.0,4,6
35,34,7,0.8450980400142568,2,5
36,34,10,1.0,2,8
37,34,17,1.2304489213782739,6,11
38,34,16,1.2041199826559248,5,11
39,34,21,1.3222192947339193,6,15
40,34,19,1.2787536009528289,5,14
41,34,14,1.146128035678238,3,11
42,34,23,1.3617278360175928,11,12
43,34,17,1.2304489213782739,8,9
44,34,17,1.2304489213782739,6,11
45,34,19,1.2787536009528289,4,15
46,34,19,1.2787536009528289,5,14
47,34,25,1.3979400086720377,10,15
48,34,32,1.505149978319906,15,17
49,34,31,1.4913616938342726,12,19
50,34,21,1.3222192947339193,7,14
51,34,21,1.3222192947339193,8,13
52,34,17,1.2304489213782739,4,13
53,34,18,1.255272505103306,10,8
54,34,12,1.0791812460476249,5,7
55,34,22,1.3424226808222062,6,16
56,34,13,1.1139433523068367,4,9
57,34,11,1.0413926851582251,3,8
58,34,16,1.2041199826559248,10,6
59,34,22,1.3424226808222062,6,16
60,34,17,1.2304489213782739,8,9
61,34,11,1.0413926851582251,5,6
62,34,8,0.9030899869919435,2,6
63,34,12,1.0791812460476249,8,4
64,34,14,1.146128035678238,4,10
65,34,10,1.0,6,4
66,34,10,1.0,3,7
67,34,12,1.0791812460476249,2,10
68,34,10,1.0,4,6
69,34,13,1.1139433523068367,1,12
70,34,6,0.7781512503836436,2,4
71,34,10,1.0,4,6
72,34,6,0.7781512503836436,2,4
73,34,5,0.6989700043360189,0,5
74,34,9,0.9542425094393249,3,6
75,34,8,0.9030899869919435,3,5
76,34,6,0.7781512503836436,3,3
77,34,6,0.7781512503836436,3,3
78,34,1,0.0,0,1
79,34,6,0.7781512503836436,1,5
80,34,7,0.8450980400142568,3,4
81,34,3,0.47712125471966244,1,2
82,34,1,0.0,1,0
83,34,1,0.0,1,0
84,34,3,0.47712125471966244,0,3
85,34,1,0.0,1,0
86,34,12,1.0791812460476249,4,8
87,34,6,0.7781512503836436,2,4
88,34,23,1.3617278360175928,4,19
89,34,26,1.414973347970818,10,16
90,34,35,1.5440680443502757,14,21
91,34,48,1.6812412373755872,18,30
92,34,37,1.568201724066995,9,28
93,34,38,1.5797835966168101,10,28
94,34,13,1.1139433523068367,2,11
95,34,19,1.2787536009528289,10,9
97,34,1,0.0,0,1
4,35,13,1.1139433523068367,6,7
5,35,8,0.9030899869919435,2,6
6,35,36,1.5563025007672873,11,25
7,35,38,1.5797835966168101,18,20
8,35,45,1.6532125137753437,13,32
9,35,43,1.6334684555795864,11,32
10,35,41,1.6127838567197355,18,23
11,35,31,1.4913616938342726,9,22
12,35,9,0.9542425094393249,2,7
13,35,10,1.0,6,4
14,35,5,0.6989700043360189,2,3
15,35,1,0.0,1,0
16,35,1,0.0,0,1
17,35,4,0.6020599913279624,2,2
18,35,2,0.3010299956639812,1,1
19,35,5,0.6989700043360189,2,3
20,35,2,0.3010299956639812,0,2
21,35,5,0.6989700043360189,0,5
22,35,8,0.9030899869919435,2,6
23,35,5,0.6989700043360189,2,3
24,35,9,0.9542425094393249,5,4
25,35,7,0.8450980400142568,0,7
26,35,4,0.6020599913279624,2,2
27,35,12,1.0791812460476249,5,7
28,35,11,1.0413926851582251,3,8
29,35,8,0.9030899869919435,4,4
30,35,13,1.1139433523068367,4,9
31,35,12,1.0791812460476249,4,8
32,35,6,0.7781512503836436,2,4
33,35,14,1.146128035678238,7,7
34,35,11,1.0413926851582251,3,8
35,35,8,0.9030899869919435,4,4
36,35,13,1.1139433523068367,7,6
37,35,18,1.255272505103306,8,10
38,35,14,1.146128035678238,4,10
39,35,18,1.255272505103306,9,9
40,35,13,1.1139433523068367,4,9
41,35,21,1.3222192947339193,10,11
42,35,12,1.0791812460476249,2,10
43,35,11,1.0413926851582251,6,5
44,35,7,0.8450980400142568,3,4
45,35,12,1.0791812460476249,5,7
46,35,16,1.2041199826559248,5,11
47,35,19,1.2787536009528289,7,12
48,35,23,1.3617278360175928,8,15
49,35,17,1.2304489213782739,7,10
50,35,13,1.1139433523068367,4,9
51,35,14,1.146128035678238,4,10
52,35,20,1.3010299956639813,9,11
53,35,19,1.2787536009528289,5,14
54,35,10,1.0,3,7
55,35,11,1.0413926851582251,4,7
56,35,15,1.1760912590556813,2,13
57,35,17,1.2304489213782739,5,12
58,35,16,1.2041199826559248,3,13
59,35,12,1.0791812460476249,3,9
60,35,15,1.1760912590556813,2,13
61,35,13,1.1139433523068367,4,9
62,35,10,1.0,4,6
63,35,14,1.146128035678238,3,11
64,35,14,1.146128035678238,5,9
65,35,12,1.0791812460476249,3,9
66,35,13,1.1139433523068367,3,10
67,35,12,1.0791812460476249,4,8
68,35,12,1.0791812460476249,6,6
69,35,15,1.1760912590556813,8,7
70,35,7,0.8450980400142568,5,2
71,35,4,0.6020599913279624,2,2
72,35,6,0.7781512503836436,1,5
73,35,8,0.9030899869919435,1,7
74,35,9,0.9542425094393249,2,7
75,35,9,0.9542425094393249,5,4
76,35,5,0.6989700043360189,2,3
77,35,5,0.6989700043360189,3,2
78,35,6,0.7781512503836436,1,5
80,35,3,0.47712125471966244,0,3
81,35,5,0.6989700043360189,2,3
82,35,2,0.3010299956639812,1,1
83,35,2,0.3010299956639812,0,2
84,35,4,0.6020599913279624,3,1
85,35,5,0.6989700043360189,0,5
86,35,10,1.0,2,8
87,35,9,0.9542425094393249,2,7
88,35,33,1.5185139398778875,12,21
89,35,31,1.4913616938342726,13,18
90,35,46,1.662757831681574,16,30
91,35,42,1.6232492903979006,18,24
92,35,40,1.6020599913279623,15,25
93,35,30,1.4771212547196624,12,18
94,35,10,1.0,3,7
95,35,12,1.0791812460476249,3,9
96,35,1,0.0,0,1
3,36,3,0.47712125471966244,1,2
4,36,8,0.9030899869919435,1,7
5,36,8,0.9030899869919435,2,6
6,36,24,1.380211241711606,6,18
7,36,19,1.2787536009528289,10,9
8,36,33,1.5185139398778875,12,21
9,36,51,1.7075701760979363,13,38
10,36,38,1.5797835966168101,13,25
11,36,45,1.6532125137753437,14,31
12,36,23,1.3617278360175928,14,9
13,36,13,1.1139433523068367,10,3
14,36,2,0.3010299956639812,1,1
15,36,4,0.6020599913279624,0,4
16,36,4,0.6020599913279624,1,3
17,36,2,0.3010299956639812,0,2
18,36,3,0.47712125471966244,0,3
19,36,5,0.6989700043360189,3,2
20,36,3,0.47712125471966244,0,3
21,36,1,0.0,1,0
22,36,1,0.0,1,0
23,36,7,0.8450980400142568,3,4
24,36,9,0.9542425094393249,2,7
25,36,7,0.8450980400142568,2,5
26,36,16,1.2041199826559248,6,10
27,36,6,0.7781512503836436,2,4
28,36,7,0.8450980400142568,4,3
29,36,8,0.9030899869919435,1,7
30,36,11,1.0413926851582251,3,8
31,36,13,1.1139433523068367,2,11
32,36,15,1.1760912590556813,8,7
33,36,6,0.7781512503836436,3,3
34,36,12,1.0791812460476249,4,8
35,36,12,1.0791812460476249,6,6
36,36,11,1.0413926851582251,5,6
37,36,16,1.2041199826559248,7,9
38,36,11,1.0413926851582251,3,8
39,36,15,1.1760912590556813,4,11
40,36,14,1.146128035678238,3,11
41,36,17,1.2304489213782739,6,11
42,36,15,1.1760912590556813,8,7
43,36,10,1.0,6,4
44,36,18,1.255272505103306,5,13
45,36,15,1.1760912590556813,9,6
46,36,20,1.3010299956639813,6,14
47,36,17,1.2304489213782739,5,12
48,36,18,1.255272505103306,11,7
49,36,29,1.462397997898956,12,17
50,36,16,1.2041199826559248,7,9
51,36,22,1.3424226808222062,9,13
52,36,10,1.0,4,6
53,36,19,1.2787536009528289,8,11
54,36,21,1.3222192947339193,9,12
55,36,14,1.146128035678238,3,11
56,36,20,1.3010299956639813,8,12
57,36,22,1.3424226808222062,10,12
58,36,9,0.9542425094393249,4,5
59,36,17,1.2304489213782739,7,10
60,36,14,1.146128035678238,4,10
61,36,11,1.0413926851582251,3,8
62,36,9,0.9542425094393249,3,6
63,36,17,1.2304489213782739,7,10
64,36,13,1.1139433523068367,7,6
65,36,22,1.3424226808222062,8,14
66,36,9,0.9542425094393249,4,5
67,36,10,1.0,1,9
68,36,10,1.0,4,6
69,36,8,0.9030899869919435,2,6
70,36,7,0.8450980400142568,4,3
71,36,12,1.0791812460476249,2,10
72,36,9,0.9542425094393249,3,6
73,36,7,0.8450980400142568,1,6
74,36,5,0.6989700043360189,1,4
75,36,8,0.9030899869919435,5,3
76,36,3,0.47712125471966244,2,1
77,36,5,0.6989700043360189,2,3
78,36,3,0.47712125471966244,3,0
79,36,3,0.47712125471966244,2,1
80,36,5,0.6989700043360189,0,5
81,36,3,0.47712125471966244,1,2
82,36,1,0.0,0,1
83,36,2,0.3010299956639812,0,2
84,36,7,0.8450980400142568,2,5
85,36,2,0.3010299956639812,1,1
86,36,19,1.2787536009528289,8,11
87,36,23,1.3617278360175928,8,15
88,36,26,1.414973347970818,4,22
89,36,29,1.462397997898956,10,19
90,36,42,1.6232492903979006,15,27
91,36,39,1.591064607026499,11,28
92,36,26,1.414973347970818,10,16
93,36,37,1.568201724066995,12,25
94,36,7,0.8450980400142568,1,6
95,36,13,1.1139433523068367,5,8
97,36,2,0.3010299956639812,1,1
2,37,2,0.3010299956639812,1,1
3,37,3,0.47712125471966244,1,2
4,37,7,0.8450980400142568,3,4
5,37,8,0.9030899869919435,3,5
6,37,22,1.3424226808222062,5,17
7,37,31,1.4913616938342726,9,22
8,37,43,1.6334684555795864,12,31
9,37,37,1.568201724066995,8,29
10,37,41,1.6127838567197355,13,28
11,37,32,1.505149978319906,14,18
12,37,18,1.255272505103306,6,12
13,37,23,1.3617278360175928,7,16
14,37,9,0.9542425094393249,2,7
15,37,8,0.9030899869919435,1,7
16,37,4,0.6020599913279624,1,3
17,37,1,0.0,0,1
18,37,3,0.47712125471966244,0,3
20,37,5,0.6989700043360189,1,4
21,37,3,0.47712125471966244,1,2
22,37,5,0.6989700043360189,2,3
23,37,1,0.0,1,0
24,37,7,0.8450980400142568,2,5
25,37,12,1.0791812460476249,3,9
26,37,15,1.1760912590556813,9,6
27,37,2,0.3010299956639812,2,0
28,37,8,0.9030899869919435,3,5
29,37,10,1.0,4,6
30,37,5,0.6989700043360189,1,4
31,37,9,0.9542425094393249,3,6
32,37,12,1.0791812460476249,4,8
33,37,8,0.9030899869919435,4,4
34,37,5,0.6989700043360189,2,3
35,37,9,0.9542425094393249,6,3
36,37,8,0.9030899869919435,5,3
37,37,15,1.1760912590556813,5,10
38,37,12,1.0791812460476249,3,9
39,37,13,1.1139433523068367,4,9
40,37,12,1.0791812460476249,7,5
41,37,5,0.6989700043360189,1,4
42,37,14,1.146128035678238,5,9
43,37,7,0.8450980400142568,1,6
44,37,7,0.8450980400142568,3,4
45,37,4,0.6020599913279624,0,4
46,37,17,1.2304489213782739,7,10
47,37,11,1.0413926851582251,5,6
48,37,19,1.2787536009528289,10,9
49,37,12,1.0791812460476249,6,6
50,37,20,1.3010299956639813,7,13
51,37,17,1.2304489213782739,7,10
52,37,14,1.146128035678238,5,9
53,37,10,1.0,4,6
54,37,9,0.9542425094393249,2,7
55,37,7,0.8450980400142568,3,4
56,37,7,0.8450980400142568,0,7
57,37,10,1.0,3,7
58,37,9,0.9542425094393249,3,6
59,37,18,1.255272505103306,7,11
60,37,9,0.9542425094393249,3,6
61,37,14,1.146128035678238,7,7
62,37,9,0.9542425094393249,3,6
63,37,13,1.1139433523068367,5,8
64,37,8,0.9030899869919435,3,5
65,37,6,0.7781512503836436,3,3
66,37,16,1.2041199826559248,5,11
67,37,6,0.7781512503836436,2,4
68,37,7,0.8450980400142568,3,4
69,37,14,1.146128035678238,7,7
70,37,9,0.9542425094393249,1,8
71,37,10,1.0,3,7
72,37,3,0.47712125471966244,0,3
73,37,8,0.9030899869919435,1,7
74,37,5,0.6989700043360189,1,4
75,37,7,0.8450980400142568,4,3
76,37,5,0.6989700043360189,1,4
77,37,6,0.7781512503836436,1,5
78,37,4,0.6020599913279624,2,2
79,37,4,0.6020599913279624,2,2
80,37,3,0.47712125471966244,1,2
81,37,3,0.47712125471966244,1,2
82,37,3,0.47712125471966244,2,1
83,37,4,0.6020599913279624,1,3
84,37,6,0.7781512503836436,2,4
85,37,7,0.8450980400142568,1,6
86,37,29,1.462397997898956,5,24
87,37,15,1.1760912590556813,6,9
88,37,43,1.6334684555795864,14,29
89,37,31,1.4913616938342726,7,24
90,37,36,1.5563025007672873,15,21
91,37,41,1.6127838567197355,20,21
92,37,35,1.5440680443502757,10,25
93,37,26,1.414973347970818,7,19
94,37,10,1.0,3,7
95,37,4,0.6020599913279624,2,2
96,37,1,0.0,0,1
4,38,11,1.0413926851582251,7,4
5,38,6,0.7781512503836436,1,5
6,38,13,1.1139433523068367,6,7
7,38,31,1.4913616938342726,11,20
8,38,47,1.6720978579357175,14,33
9,38,47,1.6720978579357175,13,34
10,38,57,1.7558748556724915,16,41
11,38,29,1.462397997898956,10,19
12,38,33,1.5185139398778875,11,22
13,38,29,1.462397997898956,13,16
14,38,15,1.1760912590556813,6,9
15,38,14,1.146128035678238,5,9
16,38,3,0.47712125471966244,2,1
17,38,2,0.3010299956639812,1,1
18,38,3,0.47712125471966244,2,1
19,38,1,0.0,0,1
20,38,4,0.6020599913279624,2,2
21,38,4,0.6020599913279624,1,3
22,38,4,0.6020599913279624,1,3
23,38,6,0.7781512503836436,3,3
24,38,4,0.6020599913279624,2,2
25,38,4,0.6020599913279624,1,3
26,38,9,0.9542425094393249,3,6
27,38,2,0.3010299956639812,0,2
28,38,6,0.7781512503836436,3,3
29,38,7,0.8450980400142568,2,5
30,38,9,0.9542425094393249,2,7
31,38,5,0.6989700043360189,3,2
32,38,7,0.8450980400142568,5,2
33,38,11,1.0413926851582251,3,8
34,38,13,1.1139433523068367,5,8
35,38,9,0.9542425094393249,3,6
36,38,16,1.2041199826559248,3,13
37,38,9,0.9542425094393249,3,6
38,38,12,1.0791812460476249,3,9
39,38,12,1.0791812460476249,5,7
40,38,17,1.2304489213782739,5,12
41,38,11,1.0413926851582251,4,7
42,38,13,1.1139433523068367,9,4
43,38,13,1.1139433523068367,3,10
44,38,8,0.9030899869919435,2,6
45,38,12,1.0791812460476249,2,10
46,38,10,1.0,3,7
47,38,16,1.2041199826559248,4,12
48,38,22,1.3424226808222062,12,10
49,38,18,1.255272505103306,4,14
50,38,19,1.2787536009528289,8,11
51,38,22,1.3424226808222062,6,16
52,38,12,1.0791812460476249,4,8
53,38,12,1.0791812460476249,4,8
54,38,10,1.0,4,6
55,38,16,1.2041199826559248,5,11
56,38,17,1.2304489213782739,6,11
57,38,14,1.146128035678238,3,11
58,38,15,1.1760912590556813,6,9
59,38,17,1.2304489213782739,9,8
60,38,10,1.0,4,6
61,38,13,1.1139433523068367,5,8
62,38,7,0.8450980400142568,5,2
63,38,12,1.0791812460476249,6,6
64,38,11,1.0413926851582251,2,9
65,38,8,0.9030899869919435,5,3
66,38,13,1.1139433523068367,5,8
67,38,11,1.0413926851582251,5,6
68,38,8,0.9030899869919435,4,4
69,38,8,0.9030899869919435,4,4
70,38,6,0.7781512503836436,2,4
71,38,6,0.7781512503836436,2,4
72,38,7,0.8450980400142568,3,4
73,38,17,1.2304489213782739,6,11
74,38,5,0.6989700043360189,3,2
75,38,8,0.9030899869919435,3,5
76,38,2,0.3010299956639812,0,2
77,38,3,0.47712125471966244,1,2
78,38,6,0.7781512503836436,4,2
79,38,4,0.6020599913279624,1,3
80,38,4,0.6020599913279624,1,3
81,38,2,0.3010299956639812,1,1
82,38,4,0.6020599913279624,3,1
83,38,3,0.47712125471966244,0,3
84,38,17,1.2304489213782739,7,10
85,38,17,1.2304489213782739,3,14
86,38,33,1.5185139398778875,8,25
87,38,34,1.5314789170422551,13,21
88,38,55,1.7403626894942439,13,42
89,38,44,1.6434526764861874,13,31
90,38,28,1.4471580313422192,12,16
91,38,35,1.5440680443502757,18,17
92,38,21,1.3222192947339193,6,15
93,38,32,1.505149978319906,11,21
94,38,11,1.0413926851582251,1,10
95,38,4,0.6020599913279624,1,3
96,38,1,0.0,0,1
2,39,1,0.0,0,1
3,39,1,0.0,0,1
4,39,7,0.8450980400142568,0,7
5,39,4,0.6020599913279624,0,4
6,39,18,1.255272505103306,8,10
7,39,27,1.4313637641589874,7,20
8,39,37,1.568201724066995,9,28
9,39,36,1.5563025007672873,11,25
10,39,42,1.6232492903979006,13,29
11,39,46,1.662757831681574,18,28
12,39,34,1.5314789170422551,17,17
13,39,38,1.5797835966168101,20,18
14,39,21,1.3222192947339193,5,16
15,39,17,1.2304489213782739,3,14
16,39,3,0.47712125471966244,2,1
17,39,6,0.7781512503836436,2,4
18,39,5,0.6989700043360189,1,4
19,39,1,0.0,0,1
20,39,3,0.47712125471966244,1,2
21,39,1,0.0,1,0
22,39,5,0.6989700043360189,0,5
23,39,4,0.6020599913279624,1,3
24,39,5,0.6989700043360189,2,3
25,39,7,0.8450980400142568,1,6
26,39,7,0.8450980400142568,0,7
27,39,10,1.0,3,7
28,39,8,0.9030899869919435,3,5
29,39,6,0.7781512503836436,2,4
30,39,10,1.0,2,8
31,39,7,0.8450980400142568,1,6
32,39,10,1.0,7,3
33,39,12,1.0791812460476249,4,8
34,39,9,0.9542425094393249,3,6
35,39,10,1.0,4,6
36,39,10,1.0,8,2
37,39,11,1.0413926851582251,2,9
38,39,13,1.1139433523068367,5,8
39,39,14,1.146128035678238,7,7
40,39,18,1.255272505103306,6,12
41,39,11,1.0413926851582251,3,8
42,39,9,0.9542425094393249,6,3
43,39,19,1.2787536009528289,10,9
44,39,17,1.2304489213782739,4,13
45,39,12,1.0791812460476249,7,5
46,39,9,0.9542425094393249,2,7
47,39,9,0.9542425094393249,4,5
48,39,8,0.9030899869919435,2,6
49,39,18,1.255272505103306,6,12
50,39,14,1.146128035678238,6,8
51,39,23,1.3617278360175928,10,13
52,39,13,1.1139433523068367,3,10
53,39,8,0.9030899869919435,3,5
54,39,11,1.0413926851582251,3,8
55,39,12,1.0791812460476249,4,8
56,39,6,0.7781512503836436,1,5
57,39,14,1.146128035678238,6,8
58,39,7,0.8450980400142568,4,3
59,39,14,1.146128035678238,5,9
60,39,6,0.7781512503836436,4,2
61,39,10,1.0,2,8
62,39,8,0.9030899869919435,0,8
63,39,14,1.146128035678238,5,9
64,39,13,1.1139433523068367,4,9
65,39,9,0.9542425094393249,2,7
66,39,6,0.7781512503836436,2,4
67,39,9,0.9542425094393249,2,7
68,39,12,1.0791812460476249,4,8
69,39,9,0.9542425094393249,1,8
70,39,10,1.0,4,6
71,39,8,0.9030899869919435,5,3
72,39,8,0.9030899869919435,3,5
73,39,7,0.8450980400142568,2,5
74,39,10,1.0,3,7
75,39,10,1.0,1,9
76,39,3,0.47712125471966244,1,2
77,39,4,0.6020599913279624,0,4
78,39,4,0.6020599913279624,3,1
80,39,6,0.7781512503836436,3,3
81,39,2,0.3010299956639812,1,1
82,39,2,0.3010299956639812,0,2
83,39,8,0.9030899869919435,5,3
84,39,13,1.1139433523068367,2,11
85,39,14,1.146128035678238,4,10
86,39,41,1.6127838567197355,15,26
87,39,32,1.505149978319906,10,22
88,39,46,1.662757831681574,18,28
89,39,57,1.7558748556724915,19,38
90,39,34,1.5314789170422551,6,28
91,39,37,1.568201724066995,18,19
92,39,17,1.2304489213782739,8,9
93,39,15,1.1760912590556813,3,12
94,39,1,0.0,0,1
95,39,7,0.8450980400142568,3,4
97,39,1,0.0,0,1
2,40,1,0.0,0,1
3,40,2,0.3010299956639812,0,2
4,40,8,0.9030899869919435,0,8
5,40,2,0.3010299956639812,0,2
6,40,14,1.146128035678238,8,6
7,40,12,1.0791812460476249,4,8
8,40,25,1.3979400086720377,8,17
9,40,45,1.6532125137753437,15,30
10,40,56,1.7481880270062005,22,34
11,40,50,1.6989700043360187,14,36
12,40,37,1.568201724066995,15,22
13,40,41,1.6127838567197355,10,31
14,40,29,1.462397997898956,6,23
15,40,37,1.568201724066995,9,28
16,40,16,1.2041199826559248,6,10
17,40,13,1.1139433523068367,2,11
18,40,3,0.47712125471966244,0,3
19,40,6,0.7781512503836436,0,6
20,40,5,0.6989700043360189,1,4
21,40,1,0.0,0,1
22,40,2,0.3010299956639812,0,2
23,40,4,0.6020599913279624,1,3
24,40,5,0.6989700043360189,3,2
25,40,7,0.8450980400142568,3,4
26,40,4,0.6020599913279624,0,4
27,40,5,0.6989700043360189,2,3
28,40,11,1.0413926851582251,6,5
29,40,8,0.9030899869919435,2,6
30,40,14,1.146128035678238,3,11
31,40,10,1.0,5,5
32,40,8,0.9030899869919435,1,7
33,40,9,0.9542425094393249,4,5
34,40,4,0.6020599913279624,1,3
35,40,5,0.6989700043360189,3,2
36,40,13,1.1139433523068367,2,11
37,40,13,1.1139433523068367,5,8
38,40,9,0.9542425094393249,1,8
39,40,6,0.7781512503836436,3,3
40,40,9,0.9542425094393249,6,3
41,40,21,1.3222192947339193,13,8
42,40,10,1.0,3,7
43,40,11,1.0413926851582251,2,9
44,40,9,0.9542425094393249,3,6
45,40,12,1.0791812460476249,4,8
46,40,15,1.1760912590556813,10,5
47,40,12,1.0791812460476249,5,7
48,40,18,1.255272505103306,6,12
49,40,18,1.255272505103306,7,11
50,40,14,1.146128035678238,7,7
51,40,19,1.2787536009528289,7,12
52,40,8,0.9030899869919435,4,4
53,40,16,1.2041199826559248,4,12
54,40,12,1.0791812460476249,3,9
55,40,15,1.1760912590556813,5,10
56,40,16,1.2041199826559248,5,11
57,40,9,0.9542425094393249,4,5
58,40,7,0.8450980400142568,1,6
59,40,9,0.9542425094393249,4,5
60,40,8,0.9030899869919435,5,3
61,40,7,0.8450980400142568,4,3
62,40,12,1.0791812460476249,6,6
63,40,13,1.1139433523068367,7,6
64,40,9,0.9542425094393249,5,4
65,40,9,0.9542425094393249,3,6
66,40,12,1.0791812460476249,2,10
67,40,8,0.9030899869919435,0,8
68,40,10,1.0,5,5
69,40,6,0.7781512503836436,4,2
70,40,5,0.6989700043360189,2,3
71,40,7,0.8450980400142568,2,5
72,40,4,0.6020599913279624,0,4
73,40,9,0.9542425094393249,4,5
74,40,6,0.7781512503836436,1,5
75,40,2,0.3010299956639812,0,2
76,40,2,0.3010299956639812,1,1
77,40,5,0.6989700043360189,0,5
78,40,3,0.47712125471966244,0,3
79,40,3,0.47712125471966244,1,2
80,40,1,0.0,0,1
81,40,3,0.47712125471966244,2,1
82,40,15,1.1760912590556813,7,8
83,40,19,1.2787536009528289,4,15
84,40,22,1.3424226808222062,10,12
85,40,26,1.414973347970818,8,18
86,40,45,1.6532125137753437,15,30
87,40,44,1.6434526764861874,14,30
88,40,48,1.6812412373755872,16,32
89,40,42,1.6232492903979006,15,27
90,40,44,1.6434526764861874,15,29
91,40,29,1.462397997898956,9,20
92,40,18,1.255272505103306,8,10
93,40,6,0.7781512503836436,2,4
94,40,1,0.0,0,1
95,40,5,0.6989700043360189,1,4
3,41,1,0.0,1,0
4,41,4,0.6020599913279624,1,3
5,41,4,0.6020599913279624,0,4
6,41,14,1.146128035678238,3,11
7,41,8,0.9030899869919435,3,5
8,41,26,1.414973347970818,7,19
9,41,21,1.3222192947339193,4,17
10,41,53,1.724275869600789,17,36
11,41,30,1.4771212547196624,8,22
12,41,34,1.5314789170422551,17,17
13,41,47,1.6720978579357175,16,31
14,41,27,1.4313637641589874,11,16
15,41,37,1.568201724066995,15,22
16,41,13,1.1139433523068367,6,7
17,41,8,0.9030899869919435,4,4
18,41,4,0.6020599913279624,2,2
19,41,5,0.6989700043360189,2,3
20,41,3,0.47712125471966244,2,1
21,41,6,0.7781512503836436,3,3
22,41,3,0.47712125471966244,0,3
23,41,5,0.6989700043360189,2,3
24,41,3,0.47712125471966244,1,2
25,41,4,0.6020599913279624,2,2
26,41,8,0.9030899869919435,5,3
27,41,8,0.9030899869919435,5,3
28,41,8,0.9030899869919435,4,4
29,41,5,0.6989700043360189,1,4
30,41,3,0.47712125471966244,2,1
31,41,8,0.9030899869919435,2,6
32,41,10,1.0,4,6
33,41,8,0.9030899869919435,6,2
34,41,10,1.0,6,4
35,41,5,0.6989700043360189,0,5
36,41,8,0.9030899869919435,2,6
37,41,12,1.0791812460476249,7,5
38,41,10,1.0,6,4
39,41,11,1.0413926851582251,5,6
40,41,12,1.0791812460476249,7,5
41,41,12,1.0791812460476249,7,5
42,41,15,1.1760912590556813,4,11
43,41,13,1.1139433523068367,7,6
44,41,13,1.1139433523068367,6,7
45,41,11,1.0413926851582251,6,5
46,41,12,1.0791812460476249,3,9
47,41,14,1.146128035678238,2,12
48,41,13,1.1139433523068367,4,9
49,41,22,1.3424226808222062,8,14
50,41,9,0.9542425094393249,2,7
51,41,11,1.0413926851582251,3,8
52,41,9,0.9542425094393249,1,8
53,41,20,1.3010299956639813,8,12
54,41,17,1.2304489213782739,8,9
55,41,12,1.0791812460476249,4,8
56,41,13,1.1139433523068367,6,7
57,41,13,1.1139433523068367,3,10
58,41,10,1.0,2,8
59,41,13,1.1139433523068367,2,11
60,41,19,1.2787536009528289,10,9
61,41,12,1.0791812460476249,6,6
62,41,11,1.0413926851582251,6,5
63,41,8,0.9030899869919435,0,8
64,41,8,0.9030899869919435,3,5
65,41,7,0.8450980400142568,3,4
66,41,8,0.9030899869919435,1,7
67,41,3,0.47712125471966244,2,1
68,41,10,1.0,5,5
69,41,9,0.9542425094393249,2,7
70,41,10,1.0,4,6
71,41,8,0.9030899869919435,3,5
72,41,3,0.47712125471966244,2,1
73,41,9,0.9542425094393249,2,7
74,41,10,1.0,4,6
75,41,5,0.6989700043360189,4,1
76,41,2,0.3010299956639812,1,1
77,41,4,0.6020599913279624,1,3
78,41,5,0.6989700043360189,1,4
79,41,1,0.0,1,0
80,41,5,0.6989700043360189,3,2
81,41,7,0.8450980400142568,2,5
82,41,17,1.2304489213782739,6,11
83,41,16,1.2041199826559248,6,10
84,41,38,1.5797835966168101,11,27
85,41,35,1.5440680443502757,11,24
86,41,44,1.6434526764861874,12,32
87,41,42,1.6232492903979006,13,29
88,41,34,1.5314789170422551,13,21
89,41,32,1.505149978319906,8,24
90,41,22,1.3424226808222062,7,15
91,41,35,1.5440680443502757,11,24
92,41,9,0.9542425094393249,2,7
93,41,17,1.2304489213782739,5,12
94,41,6,0.7781512503836436,4,2
95,41,3,0.47712125471966244,3,0
2,42,1,0.0,0,1
3,42,1,0.0,1,0
4,42,3,0.47712125471966244,0,3
6,42,10,1.0,4,6
7,42,5,0.6989700043360189,1,4
8,42,24,1.380211241711606,10,14
9,42,23,1.3617278360175928,5,18
10,42,34,1.5314789170422551,8,26
11,42,35,1.5440680443502757,12,23
12,42,50,1.6989700043360187,18,32
13,42,60,1.7781512503836436,13,47
14,42,51,1.7075701760979363,20,31
15,42,27,1.4313637641589874,6,21
16,42,33,1.5185139398778875,8,25
17,42,28,1.4471580313422192,9,19
18,42,18,1.255272505103306,5,13
19,42,15,1.1760912590556813,2,13
20,42,2,0.3010299956639812,0,2
21,42,1,0.0,0,1
22,42,4,0.6020599913279624,2,2
23,42,1,0.0,1,0
24,42,4,0.6020599913279624,2,2
25,42,4,0.6020599913279624,1,3
26,42,5,0.6989700043360189,1,4
27,42,3,0.47712125471966244,1,2
28,42,7,0.8450980400142568,3,4
29,42,3,0.47712125471966244,0,3
30,42,5,0.6989700043360189,2,3
31,42,8,0.9030899869919435,2,6
32,42,12,1.0791812460476249,3,9
33,42,4,0.6020599913279624,1,3
34,42,6,0.7781512503836436,2,4
35,42,9,0.9542425094393249,2,7
36,42,7,0.8450980400142568,0,7
37,42,8,0.9030899869919435,1,7
38,42,11,1.0413926851582251,5,6
39,42,6,0.7781512503836436,3,3
40,42,8,0.9030899869919435,3,5
41,42,9,0.9542425094393249,3,6
42,42,15,1.1760912590556813,7,8
43,42,5,0.6989700043360189,1,4
44,42,13,1.1139433523068367,7,6
45,42,12,1.0791812460476249,5,7
46,42,11,1.0413926851582251,2,9
47,42,11,1.0413926851582251,5,6
48,42,16,1.2041199826559248,7,9
49,42,11,1.0413926851582251,6,5
50,42,9,0.9542425094393249,4,5
51,42,15,1.1760912590556813,1,14
52,42,9,0.9542425094393249,2,7
53,42,16,1.2041199826559248,13,3
54,42,10,1.0,4,6
55,42,11,1.0413926851582251,2,9
56,42,9,0.9542425094393249,2,7
57,42,15,1.1760912590556813,5,10
58,42,7,0.8450980400142568,3,4
59,42,13,1.1139433523068367,5,8
60,42,7,0.8450980400142568,2,5
61,42,11,1.0413926851582251,2,9
62,42,17,1.2304489213782739,5,12
63,42,8,0.9030899869919435,4,4
64,42,7,0.8450980400142568,3,4
65,42,9,0.9542425094393249,2,7
66,42,5,0.6989700043360189,2,3
67,42,3,0.47712125471966244,1,2
68,42,5,0.6989700043360189,2,3
69,42,4,0.6020599913279624,0,4
70,42,9,0.9542425094393249,5,4
71,42,5,0.6989700043360189,2,3
72,42,6,0.7781512503836436,2,4
73,42,6,0.7781512503836436,2,4
74,42,3,0.47712125471966244,0,3
75,42,1,0.0,0,1
76,42,3,0.47712125471966244,1,2
77,42,2,0.3010299956639812,1,1
78,42,6,0.7781512503836436,0,6
79,42,9,0.9542425094393249,4,5
80,42,16,1.2041199826559248,7,9
81,42,10,1.0,3,7
82,42,34,1.5314789170422551,10,24
83,42,22,1.3424226808222062,7,15
84,42,34,1.5314789170422551,13,21
85,42,41,1.6127838567197355,16,25
86,42,43,1.6334684555795864,13,30
87,42,41,1.6127838567197355,18,23
88,42,43,1.6334684555795864,9,34
89,42,24,1.380211241711606,10,14
90,42,20,1.3010299956639813,3,17
91,42,22,1.3424226808222062,7,15
92,42,7,0.8450980400142568,3,4
93,42,4,0.6020599913279624,2,2
94,42,6,0.7781512503836436,2,4
95,42,2,0.3010299956639812,0,2
97,42,1,0.0,1,0
3,43,2,0.3010299956639812,0,2
4,43,3,0.47712125471966244,1,2
5,43,1,0.0,0,1
6,43,7,0.8450980400142568,2,5
7,43,10,1.0,2,8
8,43,16,1.2041199826559248,6,10
9,43,13,1.1139433523068367,4,9
10,43,35,1.5440680443502757,13,22
11,43,37,1.568201724066995,15,22
12,43,47,1.6720978579357175,17,30
13,43,45,1.6532125137753437,14,31
14,43,50,1.6989700043360187,16,34
15,43,34,1.5314789170422551,11,23
16,43,21,1.3222192947339193,9,12
17,43,30,1.4771212547196624,10,20
18,43,12,1.0791812460476249,6,6
19,43,23,1.3617278360175928,10,13
20,43,3,0.47712125471966244,1,2
21,43,2,0.3010299956639812,0,2
22,43,2,0.3010299956639812,2,0
23,43,7,0.8450980400142568,4,3
24,43,5,0.6989700043360189,0,5
25,43,3,0.47712125471966244,0,3
26,43,3,0.47712125471966244,1,2
27,43,5,0.6989700043360189,2,3
28,43,9,0.9542425094393249,5,4
29,43,4,0.6020599913279624,1,3
30,43,5,0.6989700043360189,2,3
31,43,5,0.6989700043360189,2,3
32,43,5,0.6989700043360189,1,4
33,43,1,0.0,1,0
34,43,7,0.8450980400142568,5,2
35,43,9,0.9542425094393249,6,3
36,43,6,0.7781512503836436,3,3
37,43,6,0.7781512503836436,2,4
38,43,11,1.0413926851582251,5,6
39,43,6,0.7781512503836436,2,4
40,43,9,0.9542425094393249,4,5
41,43,3,0.47712125471966244,1,2
42,43,8,0.9030899869919435,4,4
43,43,6,0.7781512503836436,2,4
44,43,7,0.8450980400142568,4,3
45,43,7,0.8450980400142568,2,5
46,43,13,1.1139433523068367,5,8
47,43,14,1.146128035678238,5,9
48,43,12,1.0791812460476249,4,8
49,43,14,1.146128035678238,6,8
50,43,17,1.2304489213782739,6,11
51,43,14,1.146128035678238,6,8
52,43,3,0.47712125471966244,1,2
53,43,15,1.1760912590556813,7,8
54,43,9,0.9542425094393249,4,5
55,43,9,0.9542425094393249,6,3
56,43,12,1.0791812460476249,5,7
57,43,11,1.0413926851582251,4,7
58,43,11,1.0413926851582251,2,9
59,43,8,0.9030899869919435,5,3
60,43,17,1.2304489213782739,6,11
61,43,6,0.7781512503836436,2,4
62,43,6,0.7781512503836436,2,4
63,43,10,1.0,4,6
64,43,6,0.7781512503836436,2,4
65,43,5,0.6989700043360189,1,4
66,43,8,0.9030899869919435,2,6
67,43,7,0.8450980400142568,1,6
68,43,6,0.7781512503836436,1,5
69,43,8,0.9030899869919435,5,3
70,43,9,0.9542425094393249,2,7
71,43,5,0.6989700043360189,2,3
72,43,8,0.9030899869919435,2,6
73,43,2,0.3010299956639812,1,1
74,43,1,0.0,0,1
75,43,3,0.47712125471966244,1,2
76,43,2,0.3010299956639812,1,1
77,43,6,0.7781512503836436,0,6
78,43,3,0.47712125471966244,2,1
79,43,2,0.3010299956639812,2,0
80,43,12,1.0791812460476249,3,9
81,43,13,1.1139433523068367,5,8
82,43,35,1.5440680443502757,9,26
83,43,29,1.462397997898956,10,19
84,43,39,1.591064607026499,16,23
85,43,39,1.591064607026499,16,23
86,43,43,1.6334684555795864,17,26
87,43,63,1.7993405494535817,26,37
88,43,28,1.4471580313422192,7,21
89,43,30,1.4771212547196624,13,17
90,43,19,1.2787536009528289,6,13
91,43,23,1.3617278360175928,8,15
92,43,8,0.9030899869919435,3,5
93,43,6,0.7781512503836436,1,5
95,43,4,0.6020599913279624,2,2
4,44,1,0.0,0,1
5,44,2,0.3010299956639812,1,1
6,44,11,1.0413926851582251,4,7
7,44,10,1.0,3,7
8,44,10,1.0,3,7
9,44,20,1.3010299956639813,8,12
10,44,28,1.4471580313422192,7,21
11,44,33,1.5185139398778875,13,20
12,44,41,1.6127838567197355,16,25
13,44,44,1.6434526764861874,14,30
14,44,35,1.5440680443502757,14,21
15,44,48,1.6812412373755872,15,33
16,44,49,1.6901960800285136,16,33
17,44,42,1.6232492903979006,18,24
18,44,33,1.5185139398778875,12,21
19,44,29,1.462397997898956,7,22
20,44,23,1.3617278360175928,8,15
21,44,18,1.255272505103306,6,12
22,44,4,0.6020599913279624,1,3
23,44,5,0.6989700043360189,2,3
24,44,2,0.3010299956639812,0,2
25,44,2,0.3010299956639812,1,1
26,44,9,0.9542425094393249,2,7
27,44,4,0.6020599913279624,2,2
28,44,4,0.6020599913279624,2,2
29,44,3,0.47712125471966244,1,2
30,44,8,0.9030899869919435,6,2
31,44,7,0.8450980400142568,1,6
32,44,4,0.6020599913279624,2,2
33,44,3,0.47712125471966244,2,1
34,44,7,0.8450980400142568,2,5
35,44,8,0.9030899869919435,3,5
36,44,7,0.8450980400142568,2,5
37,44,10,1.0,4,6
38,44,11,1.0413926851582251,3,8
39,44,6,0.7781512503836436,2,4
40,44,9,0.9542425094393249,3,6
41,44,16,1.2041199826559248,7,9
42,44,13,1.1139433523068367,3,10
43,44,10,1.0,2,8
44,44,11,1.0413926851582251,4,7
45,44,6,0.7781512503836436,3,3
46,44,11,1.0413926851582251,3,8
47,44,12,1.0791812460476249,8,4
48,44,11,1.0413926851582251,6,5
49,44,13,1.1139433523068367,5,8
50,44,15,1.1760912590556813,3,12
51,44,16,1.2041199826559248,6,10
52,44,14,1.146128035678238,6,8
53,44,16,1.2041199826559248,8,8
54,44,5,0.6989700043360189,2,3
55,44,10,1.0,3,7
56,44,13,1.1139433523068367,9,4
57,44,15,1.1760912590556813,9,6
58,44,7,0.8450980400142568,3,4
59,44,15,1.1760912590556813,3,12
60,44,12,1.0791812460476249,3,9
61,44,10,1.0,1,9
62,44,12,1.0791812460476249,6,6
63,44,3,0.47712125471966244,2,1
64,44,4,0.6020599913279624,2,2
65,44,8,0.9030899869919435,3,5
66,44,4,0.6020599913279624,3,1
67,44,4,0.6020599913279624,0,4
68,44,6,0.7781512503836436,3,3
69,44,12,1.0791812460476249,5,7
70,44,5,0.6989700043360189,1,4
71,44,9,0.9542425094393249,3,6
72,44,2,0.3010299956639812,1,1
73,44,2,0.3010299956639812,0,2
74,44,6,0.7781512503836436,2,4
75,44,5,0.6989700043360189,1,4
76,44,9,0.9542425094393249,6,3
77,44,5,0.6989700043360189,2,3
78,44,14,1.146128035678238,8,6
79,44,13,1.1139433523068367,3,10
80,44,38,1.5797835966168101,13,25
81,44,24,1.380211241711606,9,15
82,44,45,1.6532125137753437,14,31
83,44,41,1.6127838567197355,15,26
84,44,30,1.4771212547196624,8,22
85,44,67,1.8260748027008264,17,50
86,44,42,1.6232492903979006,13,29
87,44,48,1.6812412373755872,18,30
88,44,21,1.3222192947339193,7,14
89,44,25,1.3979400086720377,8,17
90,44,14,1.146128035678238,6,8
91,44,16,1.2041199826559248,3,13
92,44,7,0.8450980400142568,1,6
93,44,5,0.6989700043360189,2,3
94,44,3,0.47712125471966244,2,1
95,44,2,0.3010299956639812,1,1
2,45,1,0.0,0,1
5,45,2,0.3010299956639812,2,0
6,45,4,0.6020599913279624,2,2
7,45,5,0.6989700043360189,1,4
8,45,11,1.0413926851582251,3,8
9,45,16,1.2041199826559248,4,12
10,45,33,1.5185139398778875,8,25
11,45,34,1.5314789170422551,13,21
12,45,40,1.6020599913279623,15,25
13,45,42,1.6232492903979006,8,34
14,45,43,1.6334684555795864,17,26
15,45,44,1.6434526764861874,18,26
16,45,49,1.6901960800285136,19,30
17,45,38,1.5797835966168101,16,22
18,45,25,1.3979400086720377,13,12
19,45,28,1.4471580313422192,15,13
20,45,16,1.2041199826559248,2,14
21,45,14,1.146128035678238,6,8
22,45,5,0.6989700043360189,1,4
23,45,9,0.9542425094393249,2,7
24,45,1,0.0,1,0
25,45,3,0.47712125471966244,0,3
26,45,5,0.6989700043360189,2,3
27,45,6,0.7781512503836436,2,4
28,45,5,0.6989700043360189,3,2
29,45,5,0.6989700043360189,1,4
31,45,5,0.6989700043360189,1,4
32,45,10,1.0,2,8
33,45,9,0.9542425094393249,5,4
34,45,8,0.9030899869919435,3,5
35,45,11,1.0413926851582251,6,5
36,45,12,1.0791812460476249,5,7
37,45,10,1.0,3,7
38,45,10,1.0,3,7
39,45,10,1.0,5,5
40,45,13,1.1139433523068367,4,9
41,45,10,1.0,4,6
42,45,11,1.0413926851582251,5,6
43,45,8,0.9030899869919435,3,5
44,45,6,0.7781512503836436,2,4
45,45,15,1.1760912590556813,6,9
46,45,10,1.0,3,7
47,45,13,1.1139433523068367,5,8
48,45,14,1.146128035678238,5,9
49,45,13,1.1139433523068367,7,6
50,45,13,1.1139433523068367,6,7
51,45,9,0.9542425094393249,3,6
52,45,11,1.0413926851582251,4,7
53,45,11,1.0413926851582251,2,9
54,45,9,0.9542425094393249,2,7
55,45,6,0.7781512503836436,1,5
56,45,14,1.146128035678238,5,9
57,45,9,0.9542425094393249,4,5
58,45,16,1.2041199826559248,5,11
59,45,6,0.7781512503836436,2,4
60,45,12,1.0791812460476249,5,7
61,45,12,1.0791812460476249,2,10
62,45,7,0.8450980400142568,0,7
63,45,4,0.6020599913279624,3,1
64,45,3,0.47712125471966244,1,2
65,45,5,0.6989700043360189,1,4
66,45,7,0.8450980400142568,5,2
67,45,5,0.6989700043360189,2,3
68,45,1,0.0,1,0
69,45,8,0.9030899869919435,1,7
70,45,1,0.0,0,1
71,45,3,0.47712125471966244,0,3
72,45,6,0.7781512503836436,2,4
73,45,5,0.6989700043360189,1,4
74,45,2,0.3010299956639812,0,2
76,45,11,1.0413926851582251,2,9
77,45,6,0.7781512503836436,4,2
78,45,8,0.9030899869919435,2,6
79,45,16,1.2041199826559248,4,12
80,45,29,1.462397997898956,8,21
81,45,20,1.3010299956639813,5,15
82,45,41,1.6127838567197355,10,31
83,45,40,1.6020599913279623,9,31
84,45,48,1.6812412373755872,9,39
85,45,49,1.6901960800285136,14,35
86,45,30,1.4771212547196624,8,22
87,45,39,1.591064607026499,15,24
88,45,36,1.5563025007672873,16,20
89,45,20,1.3010299956639813,6,14
90,45,12,1.0791812460476249,0,12
91,45,14,1.146128035678238,3,11
92,45,4,0.6020599913279624,2,2
93,45,8,0.9030899869919435,3,5
94,45,5,0.6989700043360189,2,3
95,45,3,0.47712125471966244,0,3
96,45,1,0.0,0,1
4,46,3,0.47712125471966244,1,2
5,46,1,0.0,0,1
6,46,2,0.3010299956639812,1,1
7,46,7,0.8450980400142568,1,6
8,46,4,0.6020599913279624,0,4
9,46,9,0.9542425094393249,3,6
10,46,24,1.380211241711606,7,17
11,46,25,1.3979400086720377,12,13
12,46,45,1.6532125137753437,11,34
13,46,43,1.6334684555795864,13,30
14,46,38,1.5797835966168101,9,29
15,46,46,1.662757831681574,13,33
16,46,40,1.6020599913279623,15,25
17,46,46,1.662757831681574,9,37
18,46,46,1.662757831681574,7,39
19,46,50,1.6989700043360187,17,33
20,46,39,1.591064607026499,9,30
21,46,32,1.505149978319906,8,24
22,46,16,1.2041199826559248,8,8
23,46,19,1.2787536009528289,4,15
24,46,10,1.0,3,7
25,46,10,1.0,2,8
26,46,1,0.0,0,1
27,46,6,0.7781512503836436,2,4
28,46,3,0.47712125471966244,0,3
29,46,4,0.6020599913279624,0,4
30,46,2,0.3010299956639812,0,2
31,46,5,0.6989700043360189,1,4
32,46,7,0.8450980400142568,1,6
33,46,5,0.6989700043360189,0,5
34,46,6,0.7781512503836436,2,4
35,46,4,0.6020599913279624,1,3
36,46,11,1.0413926851582251,3,8
37,46,8,0.9030899869919435,3,5
38,46,9,0.9542425094393249,1,8
39,46,8,0.9030899869919435,4,4
40,46,8,0.9030899869919435,1,7
41,46,8,0.9030899869919435,3,5
42,46,8,0.9030899869919435,3,5
43,46,7,0.8450980400142568,3,4
44,46,13,1.1139433523068367,3,10
45,46,15,1.1760912590556813,6,9
46,46,9,0.9542425094393249,4,5
47,46,8,0.9030899869919435,3,5
48,46,15,1.1760912590556813,7,8
49,46,8,0.9030899869919435,0,8
50,46,10,1.0,4,6
51,46,7,0.8450980400142568,4,3
52,46,11,1.0413926851582251,5,6
53,46,6,0.7781512503836436,2,4
54,46,8,0.9030899869919435,3,5
55,46,7,0.8450980400142568,2,5
56,46,13,1.1139433523068367,5,8
57,46,7,0.8450980400142568,2,5
58,46,8,0.9030899869919435,2,6
59,46,5,0.6989700043360189,2,3
60,46,5,0.6989700043360189,1,4
61,46,8,0.9030899869919435,2,6
62,46,10,1.0,5,5
63,46,6,0.7781512503836436,1,5
64,46,3,0.47712125471966244,1,2
65,46,8,0.9030899869919435,3,5
66,46,4,0.6020599913279624,2,2
67,46,6,0.7781512503836436,1,5
68,46,2,0.3010299956639812,1,1
69,46,7,0.8450980400142568,1,6
70,46,5,0.6989700043360189,1,4
71,46,5,0.6989700043360189,0,5
72,46,1,0.0,0,1
73,46,5,0.6989700043360189,1,4
74,46,5,0.6989700043360189,1,4
75,46,10,1.0,4,6
76,46,20,1.3010299956639813,5,15
77,46,26,1.414973347970818,4,22
78,46,32,1.505149978319906,10,22
79,46,37,1.568201724066995,13,24
80,46,40,1.6020599913279623,11,29
81,46,42,1.6232492903979006,9,33
82,46,45,1.6532125137753437,15,30
83,46,65,1.8129133566428555,22,43
84,46,51,1.7075701760979363,18,33
85,46,37,1.568201724066995,9,28
86,46,29,1.462397997898956,8,21
87,46,32,1.505149978319906,9,23
88,46,15,1.1760912590556813,4,11
89,46,23,1.3617278360175928,4,19
90,46,8,0.9030899869919435,4,4
91,46,11,1.0413926851582251,2,9
92,46,1,0.0,0,1
93,46,5,0.6989700043360189,1,4
94,46,2,0.3010299956639812,0,2
95,46,1,0.0,0,1
4,47,2,0.3010299956639812,2,0
5,47,2,0.3010299956639812,0,2
6,47,3,0.47712125471966244,1,2
7,47,4,0.6020599913279624,3,1
8,47,7,0.8450980400142568,2,5
9,47,6,0.7781512503836436,2,4
10,47,26,1.414973347970818,7,19
11,47,21,1.3222192947339193,8,13
12,47,34,1.5314789170422551,9,25
13,47,36,1.5563025007672873,8,28
14,47,44,1.6434526764861874,14,30
15,47,37,1.568201724066995,13,24
16,47,45,1.6532125137753437,13,32
17,47,50,1.6989700043360187,17,33
18,47,30,1.4771212547196624,13,17
19,47,42,1.6232492903979006,12,30
20,47,36,1.5563025007672873,13,23
21,47,32,1.505149978319906,6,26
22,47,23,1.3617278360175928,12,11
23,47,27,1.4313637641589874,13,14
24,47,7,0.8450980400142568,4,3
25,47,4,0.6020599913279624,0,4
26,47,2,0.3010299956639812,1,1
27,47,5,0.6989700043360189,2,3
28,47,2,0.3010299956639812,1,1
29,47,3,0.47712125471966244,1,2
30,47,6,0.7781512503836436,2,4
31,47,5,0.6989700043360189,3,2
32,47,5,0.6989700043360189,2,3
33,47,5,0.6989700043360189,2,3
34,47,4,0.6020599913279624,3,1
35,47,7,0.8450980400142568,2,5
36,47,6,0.7781512503836436,4,2
37,47,6,0.7781512503836436,3,3
38,47,5,0.6989700043360189,2,3
39,47,6,0.7781512503836436,2,4
40,47,5,0.6989700043360189,1,4
41,47,11,1.0413926851582251,6,5
42,47,9,0.9542425094393249,3,6
43,47,3,0.47712125471966244,1,2
44,47,11,1.0413926851582251,5,6
45,47,4,0.6020599913279624,1,3
46,47,7,0.8450980400142568,1,6
47,47,6,0.7781512503836436,4,2
48,47,8,0.9030899869919435,3,5
49,47,8,0.9030899869919435,5,3
50,47,10,1.0,3,7
51,47,9,0.9542425094393249,3,6
52,47,5,0.6989700043360189,2,3
53,47,8,0.9030899869919435,1,7
54,47,3,0.47712125471966244,1,2
55,47,9,0.9542425094393249,5,4
56,47,10,1.0,2,8
57,47,5,0.6989700043360189,3,2
58,47,6,0.7781512503836436,1,5
59,47,9,0.9542425094393249,5,4
60,47,10,1.0,4,6
61,47,10,1.0,5,5
62,47,6,0.7781512503836436,2,4
63,47,7,0.8450980400142568,3,4
64,47,4,0.6020599913279624,0,4
65,47,6,0.7781512503836436,4,2
66,47,4,0.6020599913279624,4,0
67,47,6,0.7781512503836436,0,6
68,47,3,0.47712125471966244,1,2
69,47,5,0.6989700043360189,1,4
70,47,2,0.3010299956639812,1,1
72,47,3,0.47712125471966244,1,2
73,47,3,0.47712125471966244,1,2
74,47,13,1.1139433523068367,4,9
75,47,8,0.9030899869919435,2,6
76,47,12,1.0791812460476249,5,7
77,47,21,1.3222192947339193,6,15
78,47,38,1.5797835966168101,10,28
79,47,34,1.5314789170422551,12,22
80,47,46,1.662757831681574,13,33
81,47,40,1.6020599913279623,16,24
82,47,54,1.7323937598229686,17,37
83,47,51,1.7075701760979363,18,33
84,47,39,1.591064607026499,11,28
85,47,43,1.6334684555795864,13,30
86,47,28,1.4471580313422192,10,18
87,47,28,1.4471580313422192,12,16
88,47,18,1.255272505103306,3,15
89,47,20,1.3010299956639813,7,13
90,47,6,0.7781512503836436,3,3
91,47,9,0.9542425094393249,4,5
92,47,6,0.7781512503836436,1,5
93,47,3,0.47712125471966244,1,2
94,47,1,0.0,0,1
95,47,2,0.3010299956639812,1,1
4,48,1,0.0,0,1
6,48,3,0.47712125471966244,1,2
7,48,3,0.47712125471966244,1,2
8,48,6,0.7781512503836436,4,2
9,48,4,0.6020599913279624,1,3
10,48,15,1.1760912590556813,6,9
11,48,14,1.146128035678238,4,10
12,48,17,1.2304489213782739,7,10
13,48,24,1.380211241711606,8,16
14,48,31,1.4913616938342726,12,19
15,48,35,1.5440680443502757,13,22
16,48,27,1.4313637641589874,7,20
17,48,36,1.5563025007672873,10,26
18,48,39,1.591064607026499,13,26
19,48,38,1.5797835966168101,9,29
20,48,35,1.5440680443502757,11,24
21,48,48,1.6812412373755872,17,31
22,48,44,1.6434526764861874,15,29
23,48,31,1.4913616938342726,8,23
24,48,17,1.2304489213782739,5,12
25,48,17,1.2304489213782739,4,13
26,48,23,1.3617278360175928,9,14
27,48,11,1.0413926851582251,5,6
28,48,8,0.9030899869919435,3,5
29,48,4,0.6020599913279624,1,3
30,48,3,0.47712125471966244,1,2
31,48,2,0.3010299956639812,1,1
32,48,3,0.47712125471966244,3,0
33,48,1,0.0,0,1
34,48,6,0.7781512503836436,2,4
35,48,4,0.6020599913279624,2,2
36,48,5,0.6989700043360189,1,4
37,48,12,1.0791812460476249,3,9
38,48,8,0.9030899869919435,5,3
39,48,1,0.0,0,1
40,48,6,0.7781512503836436,4,2
41,48,13,1.1139433523068367,4,9
42,48,4,0.6020599913279624,1,3
43,48,7,0.8450980400142568,3,4
44,48,6,0.7781512503836436,4,2
45,48,7,0.8450980400142568,5,2
46,48,3,0.47712125471966244,2,1
47,48,7,0.8450980400142568,1,6
48,48,13,1.1139433523068367,9,4
49,48,13,1.1139433523068367,2,11
50,48,11,1.0413926851582251,4,7
51,48,12,1.0791812460476249,5,7
52,48,8,0.9030899869919435,2,6
53,48,11,1.0413926851582251,4,7
54,48,7,0.8450980400142568,3,4
55,48,4,0.6020599913279624,1,3
56,48,9,0.9542425094393249,3,6
57,48,5,0.6989700043360189,3,2
58,48,2,0.3010299956639812,1,1
59,48,2,0.3010299956639812,1,1
60,48,3,0.47712125471966244,2,1
61,48,5,0.6989700043360189,1,4
62,48,4,0.6020599913279624,1,3
63,48,5,0.6989700043360189,2,3
64,48,2,0.3010299956639812,2,0
65,48,5,0.6989700043360189,1,4
66,48,2,0.3010299956639812,2,0
67,48,7,0.8450980400142568,5,2
68,48,5,0.6989700043360189,3,2
69,48,5,0.6989700043360189,3,2
70,48,3,0.47712125471966244,1,2
71,48,4,0.6020599913279624,0,4
72,48,12,1.0791812460476249,2,10
73,48,16,1.2041199826559248,2,14
74,48,25,1.3979400086720377,10,15
75,48,17,1.2304489213782739,8,9
76,48,30,1.4771212547196624,11,19
77,48,36,1.5563025007672873,9,27
78,48,43,1.6334684555795864,15,28
79,48,42,1.6232492903979006,20,22
80,48,47,1.6720978579357175,12,35
81,48,46,1.662757831681574,14,32
82,48,37,1.568201724066995,9,28
83,48,52,1.7160033436347992,18,34
84,48,24,1.380211241711606,8,16
85,48,36,1.5563025007672873,11,25
86,48,16,1.2041199826559248,8,8
87,48,16,1.2041199826559248,4,12
88,48,9,0.9542425094393249,2,7
89,48,18,1.255272505103306,6,12
90,48,7,0.8450980400142568,1,6
91,48,10,1.0,5,5
92,48,2,0.3010299956639812,1,1
95,48,3,0.47712125471966244,1,2
4,49,1,0.0,1,0
6,49,2,0.3010299956639812,0,2
7,49,1,0.0,1,0
8,49,5,0.6989700043360189,1,4
9,49,5,0.6989700043360189,1,4
10,49,12,1.0791812460476249,0,12
11,49,10,1.0,3,7
12,49,27,1.4313637641589874,9,18
13,49,23,1.3617278360175928,8,15
14,49,30,1.4771212547196624,8,22
15,49,33,1.5185139398778875,13,20
16,49,38,1.5797835966168101,12,26
17,49,48,1.6812412373755872,10,38
18,49,44,1.6434526764861874,10,34
19,49,46,1.662757831681574,10,36
20,49,53,1.724275869600789,14,39
21,49,38,1.5797835966168101,11,27
22,49,44,1.6434526764861874,9,35
23,49,29,1.462397997898956,13,16
24,49,18,1.255272505103306,7,11
25,49,23,1.3617278360175928,8,15
26,49,13,1.1139433523068367,4,9
27,49,13,1.1139433523068367,6,7
28,49,6,0.7781512503836436,2,4
29,49,7,0.8450980400142568,0,7
30,49,1,0.0,1,0
31,49,4,0.6020599913279624,2,2
32,49,3,0.47712125471966244,0,3
33,49,1,0.0,1,0
34,49,2,0.3010299956639812,1,1
35,49,1,0.0,0,1
36,49,3,0.47712125471966244,2,1
37,49,4,0.6020599913279624,2,2
38,49,3,0.47712125471966244,1,2
39,49,1,0.0,0,1
40,49,6,0.7781512503836436,2,4
41,49,10,1.0,7,3
42,49,5,0.6989700043360189,1,4
43,49,3,0.47712125471966244,2,1
44,49,12,1.0791812460476249,4,8
45,49,4,0.6020599913279624,3,1
46,49,7,0.8450980400142568,1,6
47,49,8,0.9030899869919435,2,6
48,49,2,0.3010299956639812,1,1
49,49,2,0.3010299956639812,2,0
50,49,10,1.0,5,5
51,49,6,0.7781512503836436,1,5
52,49,6,0.7781512503836436,4,2
53,49,7,0.8450980400142568,4,3
54,49,6,0.7781512503836436,2,4
55,49,10,1.0,2,8
56,49,5,0.6989700043360189,3,2
57,49,9,0.9542425094393249,3,6
58,49,6,0.7781512503836436,3,3
59,49,6,0.7781512503836436,1,5
60,49,5,0.6989700043360189,2,3
61,49,3,0.47712125471966244,0,3
62,49,3,0.47712125471966244,0,3
63,49,6,0.7781512503836436,0,6
64,49,5,0.6989700043360189,2,3
65,49,4,0.6020599913279624,2,2
66,49,5,0.6989700043360189,1,4
67,49,1,0.0,1,0
68,49,4,0.6020599913279624,1,3
69,49,7,0.8450980400142568,3,4
70,49,2,0.3010299956639812,0,2
71,49,11,1.0413926851582251,3,8
72,49,17,1.2304489213782739,6,11
73,49,13,1.1139433523068367,5,8
74,49,26,1.414973347970818,12,14
75,49,19,1.2787536009528289,5,14
76,49,36,1.5563025007672873,14,22
77,49,32,1.505149978319906,9,23
78,49,41,1.6127838567197355,14,27
79,49,37,1.568201724066995,14,23
80,49,52,1.7160033436347992,21,31
81,49,46,1.662757831681574,13,33
82,49,49,1.6901960800285136,11,38
83,49,38,1.5797835966168101,14,24
84,49,37,1.568201724066995,13,24
85,49,40,1.6020599913279623,16,24
86,49,23,1.3617278360175928,3,20
87,49,10,1.0,1,9
88,49,9,0.9542425094393249,3,6
89,49,14,1.146128035678238,5,9
90,49,3,0.47712125471966244,2,1
91,49,4,0.6020599913279624,0,4
92,49,4,0.6020599913279624,1,3
93,49,2,0.3010299956639812,1,1
95,49,1,0.0,1,0
2,50,1,0.0,0,1
4,50,1,0.0,1,0
6,50,2,0.3010299956639812,0,2
7,50,3,0.47712125471966244,2,1
8,50,5,0.6989700043360189,1,4
9,50,3,0.47712125471966244,2,1
10,50,6,0.7781512503836436,4,2
11,50,6,0.7781512503836436,1,5
12,50,9,0.9542425094393249,3,6
13,50,17,1.2304489213782739,7,10
14,50,25,1.3979400086720377,12,13
15,50,29,1.462397997898956,8,21
16,50,28,1.4471580313422192,6,22
17,50,37,1.568201724066995,12,25
18,50,39,1.591064607026499,13,26
19,50,32,1.505149978319906,11,21
20,50,44,1.6434526764861874,14,30
21,50,54,1.7323937598229686,22,32
22,50,50,1.6989700043360187,10,40
23,50,37,1.568201724066995,9,28
24,50,32,1.505149978319906,10,22
25,50,39,1.591064607026499,13,26
26,50,27,1.4313637641589874,8,19
27,50,18,1.255272505103306,6,12
28,50,12,1.0791812460476249,5,7
29,50,20,1.3010299956639813,5,15
30,50,12,1.0791812460476249,3,9
31,50,18,1.255272505103306,4,14
32,50,7,0.8450980400142568,3,4
33,50,6,0.7781512503836436,2,4
35,50,4,0.6020599913279624,0,4
36,50,5,0.6989700043360189,1,4
37,50,2,0.3010299956639812,0,2
38,50,6,0.7781512503836436,2,4
39,50,5,0.6989700043360189,2,3
40,50,5,0.6989700043360189,1,4
41,50,2,0.3010299956639812,1,1
42,50,5,0.6989700043360189,1,4
43,50,4,0.6020599913279624,2,2
44,50,8,0.9030899869919435,3,5
45,50,3,0.47712125471966244,2,1
46,50,5,0.6989700043360189,3,2
47,50,11,1.0413926851582251,3,8
48,50,9,0.9542425094393249,3,6
49,50,6,0.7781512503836436,4,2
50,50,6,0.7781512503836436,1,5
51,50,10,1.0,5,5
52,50,3,0.47712125471966244,2,1
53,50,11,1.0413926851582251,4,7
54,50,6,0.7781512503836436,2,4
55,50,8,0.9030899869919435,2,6
56,50,8,0.9030899869919435,1,7
57,50,6,0.7781512503836436,2,4
58,50,6,0.7781512503836436,3,3
59,50,5,0.6989700043360189,2,3
60,50,3,0.47712125471966244,2,1
61,50,3,0.47712125471966244,2,1
62,50,1,0.0,0,1
63,50,3,0.47712125471966244,1,2
64,50,6,0.7781512503836436,4,2
65,50,4,0.6020599913279624,1,3
66,50,8,0.9030899869919435,2,6
67,50,5,0.6989700043360189,0,5
68,50,9,0.9542425094393249,4,5
69,50,11,1.0413926851582251,2,9
70,50,16,1.2041199826559248,3,13
71,50,16,1.2041199826559248,9,7
72,50,20,1.3010299956639813,4,16
73,50,24,1.380211241711606,3,21
74,50,29,1.462397997898956,8,21
75,50,32,1.505149978319906,10,22
76,50,34,1.5314789170422551,12,22
77,50,31,1.4913616938342726,7,24
78,50,37,1.568201724066995,12,25
79,50,44,1.6434526764861874,22,22
80,50,43,1.6334684555795864,11,32
81,50,38,1.5797835966168101,12,26
82,50,28,1.4471580313422192,11,17
83,50,24,1.380211241711606,5,19
84,50,24,1.380211241711606,6,18
85,50,22,1.3424226808222062,6,16
86,50,8,0.9030899869919435,3,5
87,50,12,1.0791812460476249,3,9
88,50,7,0.8450980400142568,4,3
89,50,7,0.8450980400142568,2,5
90,50,4,0.6020599913279624,2,2
92,50,3,0.47712125471966244,1,2
93,50,2,0.3010299956639812,0,2
3,51,1,0.0,0,1
4,51,2,0.3010299956639812,0,2
6,51,3,0.47712125471966244,1,2
7,51,2,0.3010299956639812,0,2
8,51,5,0.6989700043360189,3,2
9,51,2,0.3010299956639812,1,1
10,51,7,0.8450980400142568,1,6
11,51,9,0.9542425094393249,4,5
12,51,9,0.9542425094393249,2,7
13,51,14,1.146128035678238,4,10
14,51,25,1.3979400086720377,5,20
15,51,15,1.1760912590556813,5,10
16,51,33,1.5185139398778875,9,24
17,51,34,1.5314789170422551,9,25
18,51,43,1.6334684555795864,10,33
19,51,35,1.5440680443502757,11,24
20,51,44,1.6434526764861874,13,31
21,51,53,1.724275869600789,17,36
22,51,44,1.6434526764861874,11,33
23,51,46,1.662757831681574,15,31
24,51,32,1.505149978319906,7,25
25,51,29,1.462397997898956,9,20
26,51,26,1.414973347970818,10,16
27,51,29,1.462397997898956,13,16
28,51,16,1.2041199826559248,3,13
29,51,11,1.0413926851582251,1,10
30,51,7,0.8450980400142568,3,4
31,51,13,1.1139433523068367,1,12
32,51,6,0.7781512503836436,2,4
33,51,5,0.6989700043360189,1,4
35,51,2,0.3010299956639812,1,1
36,51,2,0.3010299956639812,0,2
37,51,4,0.6020599913279624,1,3
38,51,5,0.6989700043360189,4,1
39,51,3,0.47712125471966244,1,2
40,51,5,0.6989700043360189,1,4
41,51,5,0.6989700043360189,0,5
42,51,1,0.0,1,0
43,51,3,0.47712125471966244,2,1
44,51,3,0.47712125471966244,2,1
45,51,2,0.3010299956639812,0,2
46,51,5,0.6989700043360189,2,3
47,51,7,0.8450980400142568,1,6
48,51,6,0.7781512503836436,0,6
49,51,8,0.9030899869919435,1,7
50,51,2,0.3010299956639812,1,1
51,51,5,0.6989700043360189,2,3
52,51,6,0.7781512503836436,1,5
53,51,4,0.6020599913279624,0,4
54,51,5,0.6989700043360189,1,4
55,51,3,0.47712125471966244,1,2
56,51,4,0.6020599913279624,0,4
57,51,3,0.47712125471966244,3,0
58,51,7,0.8450980400142568,2,5
59,51,8,0.9030899869919435,4,4
60,51,3,0.47712125471966244,1,2
61,51,3,0.47712125471966244,0,3
62,51,5,0.6989700043360189,2,3
63,51,9,0.9542425094393249,3,6
64,51,6,0.7781512503836436,3,3
65,51,3,0.47712125471966244,0,3
66,51,8,0.9030899869919435,4,4
67,51,9,0.9542425094393249,5,4
68,51,11,1.0413926851582251,5,6
69,51,12,1.0791812460476249,5,7
70,51,19,1.2787536009528289,8,11
71,51,15,1.1760912590556813,6,9
72,51,29,1.462397997898956,12,17
73,51,22,1.3424226808222062,8,14
74,51,44,1.6434526764861874,12,32
75,51,29,1.462397997898956,17,12
76,51,44,1.6434526764861874,15,29
77,51,33,1.5185139398778875,8,25
78,51,43,1.6334684555795864,15,28
79,51,56,1.7481880270062005,23,33
80,51,34,1.5314789170422551,10,24
81,51,45,1.6532125137753437,10,35
82,51,33,1.5185139398778875,15,18
83,51,28,1.4471580313422192,6,22
84,51,17,1.2304489213782739,5,12
85,51,27,1.4313637641589874,8,19
86,51,17,1.2304489213782739,5,12
87,51,16,1.2041199826559248,3,13
88,51,7,0.8450980400142568,1,6
89,51,6,0.7781512503836436,1,5
90,51,6,0.7781512503836436,2,4
91,51,1,0.0,0,1
92,51,2,0.3010299956639812,1,1
94,51,1,0.0,0,1
5,52,2,0.3010299956639812,1,1
7,52,3,0.47712125471966244,0,3
8,52,2,0.3010299956639812,0,2
9,52,2,0.3010299956639812,1,1
10,52,4,0.6020599913279624,3,1
11,52,4,0.6020599913279624,1,3
12,52,9,0.9542425094393249,2,7
13,52,14,1.146128035678238,7,7
14,52,13,1.1139433523068367,9,4
15,52,14,1.146128035678238,5,9
16,52,24,1.380211241711606,6,18
17,52,24,1.380211241711606,7,17
18,52,31,1.4913616938342726,13,18
19,52,34,1.5314789170422551,15,19
20,52,37,1.568201724066995,13,24
21,52,33,1.5185139398778875,10,23
22,52,39,1.591064607026499,12,27
23,52,36,1.5563025007672873,17,19
24,52,32,1.505149978319906,9,23
25,52,32,1.505149978319906,10,22
26,52,28,1.4471580313422192,8,20
27,52,27,1.4313637641589874,7,20
28,52,26,1.414973347970818,11,15
29,52,35,1.5440680443502757,13,22
30,52,26,1.414973347970818,7,19
31,52,25,1.3979400086720377,8,17
32,52,9,0.9542425094393249,3,6
33,52,16,1.2041199826559248,6,10
34,52,11,1.0413926851582251,3,8
35,52,7,0.8450980400142568,3,4
36,52,7,0.8450980400142568,1,6
37,52,7,0.8450980400142568,2,5
38,52,7,0.8450980400142568,2,5
39,52,5,0.6989700043360189,3,2
40,52,7,0.8450980400142568,3,4
41,52,6,0.7781512503836436,3,3
42,52,5,0.6989700043360189,2,3
43,52,4,0.6020599913279624,1,3
44,52,2,0.3010299956639812,2,0
45,52,2,0.3010299956639812,2,0
46,52,2,0.3010299956639812,0,2
47,52,4,0.6020599913279624,0,4
48,52,7,0.8450980400142568,3,4
49,52,2,0.3010299956639812,0,2
50,52,6,0.7781512503836436,0,6
51,52,4,0.6020599913279624,2,2
52,52,4,0.6020599913279624,2,2
53,52,5,0.6989700043360189,3,2
54,52,6,0.7781512503836436,4,2
55,52,1,0.0,1,0
56,52,2,0.3010299956639812,1,1
57,52,7,0.8450980400142568,0,7
58,52,2,0.3010299956639812,0,2
59,52,2,0.3010299956639812,2,0
60,52,4,0.6020599913279624,1,3
61,52,3,0.47712125471966244,2,1
62,52,13,1.1139433523068367,9,4
63,52,12,1.0791812460476249,4,8
64,52,13,1.1139433523068367,4,9
65,52,19,1.2787536009528289,8,11
66,52,14,1.146128035678238,2,12
67,52,19,1.2787536009528289,7,12
68,52,27,1.4313637641589874,12,15
69,52,23,1.3617278360175928,9,14
70,52,29,1.462397997898956,7,22
71,52,28,1.4471580313422192,7,21
72,52,30,1.4771212547196624,9,21
73,52,44,1.6434526764861874,10,34
74,52,33,1.5185139398778875,11,22
75,52,34,1.5314789170422551,12,22
76,52,35,1.5440680443502757,10,25
77,52,36,1.5563025007672873,13,23
78,52,37,1.568201724066995,10,27
79,52,33,1.5185139398778875,13,20
80,52,30,1.4771212547196624,12,18
81,52,31,1.4913616938342726,11,20
82,52,25,1.3979400086720377,6,19
83,52,23,1.3617278360175928,8,15
84,52,33,1.5185139398778875,9,24
85,52,18,1.255272505103306,4,14
86,52,11,1.0413926851582251,5,6
87,52,11,1.0413926851582251,2,9
88,52,7,0.8450980400142568,2,5
89,52,3,0.47712125471966244,0,3
90,52,4,0.6020599913279624,0,4
92,52,1,0.0,0,1
93,52,1,0.0,0,1
3,53,1,0.0,0,1
7,53,1,0.0,1,0
8,53,1,0.0,0,1
9,53,4,0.6020599913279624,2,2
10,53,3,0.47712125471966244,1,2
11,53,4,0.6020599913279624,1,3
12,53,10,1.0,1,9
13,53,14,1.146128035678238,4,10
14,53,18,1.255272505103306,4,14
15,53,16,1.2041199826559248,5,11
16,53,26,1.414973347970818,1,25
17,53,22,1.3424226808222062,8,14
18,53,46,1.662757831681574,18,28
19,53,42,1.6232492903979006,13,29
20,53,26,1.414973347970818,7,19
21,53,42,1.6232492903979006,20,22
22,53,45,1.6532125137753437,16,29
23,53,40,1.6020599913279623,18,22
24,53,46,1.662757831681574,18,28
25,53,43,1.6334684555795864,14,29
26,53,36,1.5563025007672873,18,18
27,53,48,1.6812412373755872,15,33
28,53,36,1.5563025007672873,9,27
29,53,34,1.5314789170422551,8,26
30,53,21,1.3222192947339193,6,15
31,53,29,1.462397997898956,12,17
32,53,17,1.2304489213782739,3,14
33,53,15,1.1760912590556813,3,12
34,53,15,1.1760912590556813,7,8
35,53,12,1.0791812460476249,3,9
36,53,8,0.9030899869919435,1,7
37,53,3,0.47712125471966244,0,3
38,53,6,0.7781512503836436,3,3
39,53,1,0.0,0,1
40,53,4,0.6020599913279624,2,2
41,53,2,0.3010299956639812,1,1
42,53,6,0.7781512503836436,1,5
43,53,7,0.8450980400142568,3,4
44,53,3,0.47712125471966244,0,3
45,53,5,0.6989700043360189,2,3
46,53,1,0.0,0,1
47,53,8,0.9030899869919435,2,6
48,53,7,0.8450980400142568,1,6
49,53,10,1.0,3,7
50,53,3,0.47712125471966244,0,3
51,53,6,0.7781512503836436,2,4
52,53,4,0.6020599913279624,1,3
53,53,5,0.6989700043360189,1,4
54,53,5,0.6989700043360189,2,3
56,53,4,0.6020599913279624,2,2
57,53,3,0.47712125471966244,2,1
58,53,8,0.9030899869919435,4,4
59,53,5,0.6989700043360189,2,3
60,53,8,0.9030899869919435,3,5
61,53,11,1.0413926851582251,3,8
62,53,15,1.1760912590556813,5,10
63,53,11,1.0413926851582251,2,9
64,53,15,1.1760912590556813,9,6
65,53,10,1.0,3,7
66,53,20,1.3010299956639813,4,16
67,53,19,1.2787536009528289,5,14
68,53,26,1.414973347970818,9,17
69,53,31,1.4913616938342726,9,22
70,53,37,1.568201724066995,11,26
71,53,33,1.5185139398778875,12,21
72,53,41,1.6127838567197355,18,23
73,53,31,1.4913616938342726,15,16
74,53,35,1.5440680443502757,6,29
75,53,29,1.462397997898956,8,21
76,53,50,1.6989700043360187,13,37
77,53,40,1.6020599913279623,9,31
78,53,31,1.4913616938342726,7,24
79,53,39,1.591064607026499,14,25
80,53,34,1.5314789170422551,8,26
81,53,28,1.4471580313422192,5,23
82,53,20,1.3010299956639813,7,13
83,53,24,1.380211241711606,5,19
84,53,19,1.2787536009528289,3,16
85,53,17,1.2304489213782739,5,12
86,53,11,1.0413926851582251,5,6
87,53,11,1.0413926851582251,3,8
88,53,5,0.6989700043360189,1,4
89,53,4,0.6020599913279624,0,4
6,54,1,0.0,1,0
8,54,1,0.0,0,1
9,54,2,0.3010299956639812,1,1
10,54,1,0.0,0,1
11,54,1,0.0,0,1
12,54,6,0.7781512503836436,1,5
13,54,3,0.47712125471966244,1,2
14,54,14,1.146128035678238,3,11
15,54,10,1.0,4,6
16,54,16,1.2041199826559248,3,13
17,54,21,1.3222192947339193,6,15
18,54,25,1.3979400086720377,3,22
19,54,32,1.505149978319906,11,21
20,54,35,1.5440680443502757,16,19
21,54,28,1.4471580313422192,9,19
22,54,31,1.4913616938342726,9,22
23,54,29,1.462397997898956,9,20
24,54,36,1.5563025007672873,9,27
25,54,33,1.5185139398778875,12,21
26,54,28,1.4471580313422192,5,23
27,54,34,1.5314789170422551,11,23
28,54,32,1.505149978319906,12,20
29,54,34,1.5314789170422551,13,21
30,54,29,1.462397997898956,8,21
31,54,46,1.662757831681574,12,34
32,54,20,1.3010299956639813,5,15
33,54,20,1.3010299956639813,5,15
34,54,30,1.4771212547196624,7,23
35,54,22,1.3424226808222062,9,13
36,54,21,1.3222192947339193,10,11
37,54,19,1.2787536009528289,3,16
38,54,10,1.0,2,8
39,54,19,1.2787536009528289,5,14
40,54,11,1.0413926851582251,2,9
41,54,19,1.2787536009528289,6,13
42,54,14,1.146128035678238,6,8
43,54,17,1.2304489213782739,7,10
44,54,19,1.2787536009528289,4,15
45,54,21,1.3222192947339193,2,19
46,54,10,1.0,2,8
47,54,13,1.1139433523068367,4,9
48,54,16,1.2041199826559248,3,13
49,54,12,1.0791812460476249,5,7
50,54,13,1.1139433523068367,2,11
51,54,21,1.3222192947339193,10,11
52,54,10,1.0,3,7
53,54,8,0.9030899869919435,3,5
54,54,15,1.1760912590556813,10,5
55,54,17,1.2304489213782739,5,12
56,54,19,1.2787536009528289,9,10
57,54,12,1.0791812460476249,6,6
58,54,13,1.1139433523068367,3,10
59,54,19,1.2787536009528289,10,9
60,54,22,1.3424226808222062,7,15
61,54,15,1.1760912590556813,7,8
62,54,19,1.2787536009528289,6,13
63,54,19,1.2787536009528289,4,15
64,54,20,1.3010299956639813,4,16
65,54,27,1.4313637641589874,8,19
66,54,19,1.2787536009528289,4,15
67,54,25,1.3979400086720377,10,15
68,54,24,1.380211241711606,9,15
69,54,32,1.505149978319906,11,21
70,54,42,1.6232492903979006,13,29
71,54,38,1.5797835966168101,12,26
72,54,27,1.4313637641589874,12,15
73,54,39,1.591064607026499,11,28
74,54,25,1.3979400086720377,13,12
75,54,40,1.6020599913279623,13,27
76,54,36,1.5563025007672873,11,25
77,54,36,1.5563025007672873,13,23
78,54,31,1.4913616938342726,11,20
79,54,31,1.4913616938342726,10,21
80,54,32,1.505149978319906,10,22
81,54,27,1.4313637641589874,11,16
82,54,14,1.146128035678238,6,8
83,54,17,1.2304489213782739,4,13
84,54,9,0.9542425094393249,4,5
85,54,11,1.0413926851582251,3,8
86,54,5,0.6989700043360189,4,1
87,54,7,0.8450980400142568,2,5
88,54,2,0.3010299956639812,0,2
89,54,3,0.47712125471966244,1,2
91,54,1,0.0,0,1
95,54,1,0.0,1,0
8,55,1,0.0,0,1
9,55,1,0.0,0,1
10,55,2,0.3010299956639812,0,2
11,55,2,0.3010299956639812,0,2
12,55,6,0.7781512503836436,2,4
13,55,6,0.7781512503836436,1,5
14,55,11,1.0413926851582251,3,8
15,55,13,1.1139433523068367,4,9
16,55,14,1.146128035678238,3,11
17,55,17,1.2304489213782739,4,13
18,55,23,1.3617278360175928,9,14
19,55,26,1.414973347970818,9,17
20,55,33,1.5185139398778875,6,27
21,55,24,1.380211241711606,9,15
22,55,40,1.6020599913279623,10,30
23,55,36,1.5563025007672873,14,22
24,55,35,1.5440680443502757,10,25
25,55,25,1.3979400086720377,9,16
26,55,38,1.5797835966168101,7,31
27,55,37,1.568201724066995,10,27
28,55,37,1.568201724066995,14,23
29,55,39,1.591064607026499,4,35
30,55,24,1.380211241711606,9,15
31,55,26,1.414973347970818,10,16
32,55,16,1.2041199826559248,6,10
33,55,34,1.5314789170422551,11,23
34,55,25,1.3979400086720377,16,9
35,55,20,1.3010299956639813,10,10
36,55,16,1.2041199826559248,5,11
37,55,23,1.3617278360175928,8,15
38,55,20,1.3010299956639813,8,12
39,55,19,1.2787536009528289,0,19
40,55,11,1.0413926851582251,5,6
41,55,17,1.2304489213782739,8,9
42,55,12,1.0791812460476249,5,7
43,55,19,1.2787536009528289,3,16
44,55,9,0.9542425094393249,3,6
45,55,18,1.255272505103306,5,13
46,55,15,1.1760912590556813,5,10
47,55,12,1.0791812460476249,4,8
48,55,16,1.2041199826559248,5,11
49,55,10,1.0,2,8
50,55,15,1.1760912590556813,4,11
51,55,21,1.3222192947339193,7,14
52,55,10,1.0,2,8
53,55,13,1.1139433523068367,8,5
54,55,16,1.2041199826559248,6,10
55,55,18,1.255272505103306,5,13
56,55,9,0.9542425094393249,5,4
57,55,18,1.255272505103306,6,12
58,55,19,1.2787536009528289,7,12
59,55,13,1.1139433523068367,2,11
60,55,9,0.9542425094393249,2,7
61,55,16,1.2041199826559248,5,11
62,55,21,1.3222192947339193,8,13
63,55,18,1.255272505103306,5,13
64,55,18,1.255272505103306,7,11
65,55,24,1.380211241711606,9,15
66,55,35,1.5440680443502757,11,24
67,55,31,1.4913616938342726,8,23
68,55,38,1.5797835966168101,14,24
69,55,29,1.462397997898956,10,19
70,55,36,1.5563025007672873,17,19
71,55,33,1.5185139398778875,12,21
72,55,38,1.5797835966168101,12,26
73,55,35,1.5440680443502757,7,28
74,55,34,1.5314789170422551,10,24
75,55,37,1.568201724066995,11,26
76,55,26,1.414973347970818,8,18
77,55,32,1.505149978319906,9,23
78,55,19,1.2787536009528289,4,15
79,55,32,1.505149978319906,15,17
80,55,17,1.2304489213782739,2,15
81,55,38,1.5797835966168101,13,25
82,55,24,1.380211241711606,11,13
83,55,8,0.9030899869919435,3,5
84,55,14,1.146128035678238,3,11
85,55,8,0.9030899869919435,3,5
86,55,5,0.6989700043360189,2,3
87,55,7,0.8450980400142568,3,4
88,55,4,0.6020599913279624,1,3
89,55,4,0.6020599913279624,2,2
90,55,1,0.0,0,1
91,55,2,0.3010299956639812,1,1
94,55,1,0.0,0,1
95,55,1,0.0,0,1
5,56,1,0.0,1,0
6,56,1,0.0,0,1
9,56,1,0.0,1,0
10,56,3,0.47712125471966244,0,3
12,56,4,0.6020599913279624,0,4
13,56,3,0.47712125471966244,0,3
14,56,2,0.3010299956639812,0,2
15,56,9,0.9542425094393249,2,7
16,56,7,0.8450980400142568,0,7
17,56,7,0.8450980400142568,4,3
18,56,15,1.1760912590556813,3,12
19,56,15,1.1760912590556813,6,9
20,56,21,1.3222192947339193,8,13
21,56,20,1.3010299956639813,6,14
22,56,29,1.462397997898956,10,19
23,56,26,1.414973347970818,8,18
24,56,23,1.3617278360175928,5,18
25,56,33,1.5185139398778875,10,23
26,56,30,1.4771212547196624,9,21
27,56,30,1.4771212547196624,7,23
28,56,26,1.414973347970818,8,18
29,56,35,1.5440680443502757,13,22
30,56,17,1.2304489213782739,6,11
31,56,22,1.3424226808222062,10,12
32,56,26,1.414973347970818,10,16
33,56,28,1.4471580313422192,12,16
34,56,31,1.4913616938342726,11,20
35,56,33,1.5185139398778875,11,22
36,56,22,1.3424226808222062,6,16
37,56,21,1.3222192947339193,7,14
38,56,27,1.4313637641589874,3,24
39,56,29,1.462397997898956,9,20
40,56,22,1.3424226808222062,6,16
41,56,17,1.2304489213782739,9,8
42,56,24,1.380211241711606,8,16
43,56,23,1.3617278360175928,6,17
44,56,40,1.6020599913279623,12,28
45,56,32,1.505149978319906,14,18
46,56,24,1.380211241711606,9,15
47,56,48,1.6812412373755872,18,30
48,56,35,1.5440680443502757,12,23
49,56,30,1.4771212547196624,11,19
50,56,48,1.6812412373755872,17,31
51,56,36,1.5563025007672873,6,30
52,56,26,1.414973347970818,12,14
53,56,27,1.4313637641589874,12,15
54,56,16,1.2041199826559248,5,11
55,56,16,1.2041199826559248,1,15
56,56,19,1.2787536009528289,4,15
57,56,39,1.591064607026499,15,24
58,56,26,1.414973347970818,6,20
59,56,27,1.4313637641589874,5,22
60,56,24,1.380211241711606,13,11
61,56,19,1.2787536009528289,5,14
62,56,23,1.3617278360175928,3,20
63,56,26,1.414973347970818,12,14
64,56,28,1.4471580313422192,7,21
65,56,28,1.4471580313422192,9,19
66,56,26,1.414973347970818,4,22
67,56,33,1.5185139398778875,7,26
68,56,32,1.505149978319906,5,27
69,56,19,1.2787536009528289,9,10
70,56,26,1.414973347970818,8,18
71,56,27,1.4313637641589874,9,18
72,56,34,1.5314789170422551,10,24
73,56,26,1.414973347970818,6,20
74,56,32,1.505149978319906,7,25
75,56,22,1.3424226808222062,10,12
76,56,30,1.4771212547196624,9,21
77,56,24,1.380211241711606,8,16
78,56,19,1.2787536009528289,6,13
79,56,17,1.2304489213782739,8,9
80,56,15,1.1760912590556813,6,9
81,56,6,0.7781512503836436,1,5
82,56,12,1.0791812460476249,5,7
83,56,11,1.0413926851582251,3,8
84,56,6,0.7781512503836436,1,5
85,56,6,0.7781512503836436,1,5
86,56,3,0.47712125471966244,1,2
88,56,2,0.3010299956639812,0,2
89,56,3,0.47712125471966244,2,1
90,56,1,0.0,0,1
91,56,1,0.0,0,1
94,56,1,0.0,1,0
4,57,2,0.3010299956639812,1,1
6,57,1,0.0,0,1
7,57,1,0.0,0,1
8,57,1,0.0,1,0
9,57,1,0.0,0,1
10,57,2,0.3010299956639812,1,1
11,57,3,0.47712125471966244,1,2
12,57,5,0.6989700043360189,1,4
13,57,3,0.47712125471966244,1,2
14,57,3,0.47712125471966244,2,1
15,57,5,0.6989700043360189,3,2
16,57,14,1.146128035678238,7,7
17,57,8,0.9030899869919435,4,4
18,57,8,0.9030899869919435,3,5
19,57,16,1.2041199826559248,5,11
20,57,28,1.4471580313422192,5,23
21,57,14,1.146128035678238,2,12
22,57,28,1.4471580313422192,12,16
23,57,23,1.3617278360175928,7,16
24,57,28,1.4471580313422192,6,22
25,57,28,1.4471580313422192,6,22
26,57,34,1.5314789170422551,14,20
27,57,38,1.5797835966168101,11,27
28,57,33,1.5185139398778875,13,20
29,57,33,1.5185139398778875,10,23
30,57,27,1.4313637641589874,8,19
31,57,34,1.5314789170422551,11,23
32,57,36,1.5563025007672873,11,25
33,57,14,1.146128035678238,5,9
34,57,20,1.3010299956639813,7,13
35,57,34,1.5314789170422551,12,22
36,57,31,1.4913616938342726,10,21
37,57,18,1.255272505103306,10,8
38,57,33,1.5185139398778875,10,23
39,57,23,1.3617278360175928,5,18
40,57,20,1.3010299956639813,8,12
41,57,24,1.380211241711606,10,14
42,57,29,1.462397997898956,13,16
43,57,30,1.4771212547196624,6,24
44,57,27,1.4313637641589874,8,19
45,57,21,1.3222192947339193,10,11
46,57,35,1.5440680443502757,13,22
47,57,31,1.4913616938342726,6,25
48,57,30,1.4771212547196624,10,20
49,57,34,1.5314789170422551,8,26
50,57,44,1.6434526764861874,15,29
51,57,22,1.3424226808222062,8,14
52,57,43,1.6334684555795864,15,28
53,57,23,1.3617278360175928,5,18
54,57,27,1.4313637641589874,13,14
55,57,33,1.5185139398778875,8,25
56,57,33,1.5185139398778875,9,24
57,57,20,1.3010299956639813,8,12
58,57,22,1.3424226808222062,10,12
59,57,26,1.414973347970818,7,19
60,57,31,1.4913616938342726,11,20
61,57,28,1.4471580313422192,7,21
62,57,26,1.414973347970818,10,16
63,57,30,1.4771212547196624,15,15
64,57,32,1.505149978319906,13,19
65,57,23,1.3617278360175928,9,14
66,57,26,1.414973347970818,7,19
67,57,28,1.4471580313422192,11,17
68,57,33,1.5185139398778875,9,24
69,57,38,1.5797835966168101,15,23
70,57,34,1.5314789170422551,11,23
71,57,33,1.5185139398778875,11,22
72,57,30,1.4771212547196624,9,21
73,57,35,1.5440680443502757,16,19
74,57,22,1.3424226808222062,3,19
75,57,30,1.4771212547196624,12,18
76,57,21,1.3222192947339193,7,14
77,57,20,1.3010299956639813,7,13
78,57,22,1.3424226808222062,8,14
79,57,21,1.3222192947339193,7,14
80,57,7,0.8450980400142568,3,4
81,57,9,0.9542425094393249,3,6
82,57,4,0.6020599913279624,2,2
83,57,6,0.7781512503836436,2,4
84,57,5,0.6989700043360189,0,5
85,57,9,0.9542425094393249,5,4
86,57,2,0.3010299956639812,1,1
87,57,1,0.0,0,1
88,57,2,0.3010299956639812,0,2
89,57,1,0.0,1,0
95,57,2,0.3010299956639812,1,1
8,58,1,0.0,0,1
9,58,1,0.0,1,0
10,58,4,0.6020599913279624,0,4
12,58,2,0.3010299956639812,1,1
13,58,1,0.0,1,0
14,58,3,0.47712125471966244,1,2
15,58,4,0.6020599913279624,3,1
16,58,6,0.7781512503836436,3,3
17,58,7,0.8450980400142568,1,6
18,58,8,0.9030899869919435,1,7
19,58,11,1.0413926851582251,5,6
20,58,13,1.1139433523068367,5,8
21,58,10,1.0,3,7
22,58,16,1.2041199826559248,5,11
23,58,20,1.3010299956639813,7,13
24,58,21,1.3222192947339193,6,15
25,58,19,1.2787536009528289,9,10
26,58,25,1.3979400086720377,11,14
27,58,30,1.4771212547196624,9,21
28,58,28,1.4471580313422192,4,24
29,58,27,1.4313637641589874,9,18
30,58,21,1.3222192947339193,10,11
31,58,28,1.4471580313422192,9,19
32,58,23,1.3617278360175928,9,14
33,58,30,1.4771212547196624,12,18
34,58,29,1.462397997898956,10,19
35,58,24,1.380211241711606,5,19
36,58,30,1.4771212547196624,10,20
37,58,24,1.380211241711606,10,14
38,58,31,1.4913616938342726,12,19
39,58,17,1.2304489213782739,6,11
40,58,21,1.3222192947339193,6,15
41,58,21,1.3222192947339193,4,17
42,58,31,1.4913616938342726,9,22
43,58,17,1.2304489213782739,5,12
44,58,25,1.3979400086720377,8,17
45,58,35,1.5440680443502757,9,26
46,58,35,1.5440680443502757,11,24
47,58,25,1.3979400086720377,9,16
48,58,35,1.5440680443502757,14,21
49,58,46,1.662757831681574,15,31
50,58,32,1.505149978319906,5,27
51,58,53,1.724275869600789,14,39
52,58,37,1.568201724066995,11,26
53,58,39,1.591064607026499,13,26
54,58,35,1.5440680443502757,13,22
55,58,35,1.5440680443502757,15,20
56,58,37,1.568201724066995,10,27
57,58,29,1.462397997898956,7,22
58,58,16,1.2041199826559248,4,12
59,58,18,1.255272505103306,7,11
60,58,26,1.414973347970818,8,18
61,58,22,1.3424226808222062,7,15
62,58,33,1.5185139398778875,15,18
63,58,15,1.1760912590556813,4,11
64,58,22,1.3424226808222062,6,16
65,58,20,1.3010299956639813,7,13
66,58,20,1.3010299956639813,7,13
67,58,23,1.3617278360175928,10,13
68,58,20,1.3010299956639813,7,13
69,58,25,1.3979400086720377,7,18
70,58,27,1.4313637641589874,9,18
71,58,27,1.4313637641589874,13,14
72,58,24,1.380211241711606,7,17
73,58,27,1.4313637641589874,11,16
74,58,17,1.2304489213782739,8,9
75,58,22,1.3424226808222062,6,16
76,58,19,1.2787536009528289,3,16
77,58,12,1.0791812460476249,2,10
78,58,13,1.1139433523068367,3,10
79,58,11,1.0413926851582251,2,9
80,58,7,0.8450980400142568,2,5
81,58,5,0.6989700043360189,0,5
82,58,4,0.6020599913279624,3,1
83,58,7,0.8450980400142568,2,5
84,58,4,0.6020599913279624,1,3
85,58,2,0.3010299956639812,0,2
86,58,2,0.3010299956639812,0,2
87,58,1,0.0,1,0
88,58,1,0.0,0,1
89,58,1,0.0,0,1
8,59,1,0.0,0,1
10,59,2,0.3010299956639812,0,2
12,59,1,0.0,0,1
13,59,1,0.0,0,1
14,59,3,0.47712125471966244,0,3
15,59,4,0.6020599913279624,2,2
16,59,5,0.6989700043360189,1,4
17,59,2,0.3010299956639812,0,2
18,59,10,1.0,2,8
19,59,12,1.0791812460476249,4,8
20,59,13,1.1139433523068367,4,9
21,59,9,0.9542425094393249,2,7
22,59,13,1.1139433523068367,3,10
23,59,17,1.2304489213782739,1,16
24,59,22,1.3424226808222062,5,17
25,59,20,1.3010299956639813,7,13
26,59,29,1.462397997898956,7,22
27,59,29,1.462397997898956,12,17
28,59,20,1.3010299956639813,6,14
29,59,24,1.380211241711606,11,13
30,59,26,1.414973347970818,7,19
31,59,25,1.3979400086720377,4,21
32,59,28,1.4471580313422192,7,21
33,59,31,1.4913616938342726,10,21
34,59,19,1.2787536009528289,5,14
35,59,26,1.414973347970818,5,21
36,59,28,1.4471580313422192,8,20
37,59,24,1.380211241711606,8,16
38,59,21,1.3222192947339193,5,16
39,59,27,1.4313637641589874,10,17
40,59,31,1.4913616938342726,10,21
41,59,25,1.3979400086720377,5,20
42,59,35,1.5440680443502757,9,26
43,59,30,1.4771212547196624,10,20
44,59,48,1.6812412373755872,22,26
45,59,27,1.4313637641589874,11,16
46,59,35,1.5440680443502757,6,29
47,59,38,1.5797835966168101,12,26
48,59,48,1.6812412373755872,10,38
49,59,38,1.5797835966168101,10,28
50,59,42,1.6232492903979006,14,28
51,59,36,1.5563025007672873,11,25
52,59,61,1.7853298350107671,21,40
53,59,41,1.6127838567197355,12,29
54,59,26,1.414973347970818,8,18
55,59,31,1.4913616938342726,12,19
56,59,33,1.5185139398778875,17,16
57,59,24,1.380211241711606,6,18
58,59,31,1.4913616938342726,8,23
59,59,32,1.505149978319906,10,22
60,59,26,1.414973347970818,10,16
61,59,31,1.4913616938342726,11,20
62,59,25,1.3979400086720377,9,16
63,59,28,1.4471580313422192,12,16
64,59,28,1.4471580313422192,6,22
65,59,33,1.5185139398778875,12,21
66,59,22,1.3424226808222062,10,12
67,59,27,1.4313637641589874,5,22
68,59,28,1.4471580313422192,10,18
69,59,31,1.4913616938342726,7,24
70,59,24,1.380211241711606,11,13
71,59,21,1.3222192947339193,8,13
72,59,22,1.3424226808222062,4,18
73,59,16,1.2041199826559248,4,12
74,59,19,1.2787536009528289,8,11
75,59,22,1.3424226808222062,4,18
76,59,13,1.1139433523068367,5,8
77,59,13,1.1139433523068367,3,10
78,59,12,1.0791812460476249,1,11
79,59,10,1.0,3,7
80,59,6,0.7781512503836436,2,4
81,59,1,0.0,0,1
82,59,3,0.47712125471966244,1,2
83,59,3,0.47712125471966244,0,3
84,59,1,0.0,1,0
85,59,4,0.6020599913279624,0,4
86,59,2,0.3010299956639812,0,2
88,59,2,0.3010299956639812,0,2
89,59,3,0.47712125471966244,2,1
90,59,2,0.3010299956639812,0,2
93,59,1,0.0,0,1
13,60,1,0.0,0,1
14,60,3,0.47712125471966244,0,3
15,60,4,0.6020599913279624,1,3
16,60,1,0.0,1,0
17,60,1,0.0,1,0
18,60,8,0.9030899869919435,3,5
19,60,2,0.3010299956639812,0,2
20,60,8,0.9030899869919435,2,6
21,60,2,0.3010299956639812,0,2
22,60,11,1.0413926851582251,4,7
23,60,6,0.7781512503836436,2,4
24,60,13,1.1139433523068367,5,8
25,60,10,1.0,3,7
26,60,17,1.2304489213782739,4,13
27,60,24,1.380211241711606,5,19
28,60,21,1.3222192947339193,4,17
29,60,21,1.3222192947339193,10,11
30,60,26,1.414973347970818,6,20
31,60,29,1.462397997898956,8,21
32,60,20,1.3010299956639813,7,13
33,60,17,1.2304489213782739,5,12
34,60,22,1.3424226808222062,7,15
35,60,23,1.3617278360175928,6,17
36,60,21,1.3222192947339193,6,15
37,60,27,1.4313637641589874,6,21
38,60,25,1.3979400086720377,10,15
39,60,27,1.4313637641589874,6,21
40,60,24,1.380211241711606,10,14
41,60,20,1.3010299956639813,8,12
42,60,28,1.4471580313422192,9,19
43,60,32,1.505149978319906,13,19
44,60,32,1.505149978319906,8,24
45,60,34,1.5314789170422551,12,22
46,60,32,1.505149978319906,10,22
47,60,32,1.505149978319906,8,24
48,60,42,1.6232492903979006,13,29
49,60,39,1.591064607026499,7,32
50,60,28,1.4471580313422192,9,19
51,60,42,1.6232492903979006,16,26
52,60,37,1.568201724066995,10,27
53,60,28,1.4471580313422192,14,14
54,60,28,1.4471580313422192,9,19
55,60,35,1.5440680443502757,9,26
56,60,19,1.2787536009528289,5,14
57,60,33,1.5185139398778875,12,21
58,60,18,1.255272505103306,7,11
59,60,26,1.414973347970818,8,18
60,60,32,1.505149978319906,10,22
61,60,23,1.3617278360175928,10,13
62,60,25,1.3979400086720377,6,19
63,60,33,1.5185139398778875,12,21
64,60,27,1.4313637641589874,5,22
65,60,29,1.462397997898956,8,21
66,60,20,1.3010299956639813,4,16
67,60,29,1.462397997898956,8,21
68,60,19,1.2787536009528289,2,17
69,60,32,1.505149978319906,6,26
70,60,18,1.255272505103306,4,14
71,60,26,1.414973347970818,5,21
72,60,21,1.3222192947339193,8,13
73,60,12,1.0791812460476249,4,8
74,60,12,1.0791812460476249,3,9
75,60,17,1.2304489213782739,3,14
76,60,4,0.6020599913279624,1,3
77,60,7,0.8450980400142568,3,4
78,60,6,0.7781512503836436,1,5
79,60,6,0.7781512503836436,3,3
80,60,5,0.6989700043360189,1,4
81,60,6,0.7781512503836436,3,3
82,60,3,0.47712125471966244,1,2
83,60,2,0.3010299956639812,0,2
85,60,5,0.6989700043360189,0,5
86,60,1,0.0,0,1
87,60,1,0.0,0,1
88,60,3,0.47712125471966244,2,1
91,60,1,0.0,0,1
6,61,1,0.0,0,1
7,61,1,0.0,0,1
9,61,1,0.0,0,1
10,61,1,0.0,1,0
11,61,1,0.0,0,1
12,61,1,0.0,0,1
13,61,1,0.0,1,0
14,61,2,0.3010299956639812,1,1
15,61,1,0.0,0,1
16,61,2,0.3010299956639812,1,1
17,61,2,0.3010299956639812,1,1
18,61,3,0.47712125471966244,0,3
19,61,1,0.0,0,1
20,61,6,0.7781512503836436,1,5
21,61,5,0.6989700043360189,1,4
22,61,11,1.0413926851582251,5,6
23,61,4,0.6020599913279624,2,2
24,61,14,1.146128035678238,7,7
25,61,10,1.0,2,8
26,61,22,1.3424226808222062,5,17
27,61,18,1.255272505103306,7,11
28,61,14,1.146128035678238,5,9
29,61,19,1.2787536009528289,4,15
30,61,29,1.462397997898956,12,17
31,61,22,1.3424226808222062,8,14
32,61,20,1.3010299956639813,7,13
33,61,23,1.3617278360175928,7,16
34,61,27,1.4313637641589874,13,14
35,61,24,1.380211241711606,6,18
36,61,27,1.4313637641589874,9,18
37,61,22,1.3424226808222062,7,15
38,61,28,1.4471580313422192,11,17
39,61,26,1.414973347970818,12,14
40,61,22,1.3424226808222062,5,17
41,61,29,1.462397997898956,13,16
42,61,32,1.505149978319906,12,20
43,61,23,1.3617278360175928,7,16
44,61,24,1.380211241711606,9,15
45,61,25,1.3979400086720377,10,15
46,61,40,1.6020599913279623,19,21
47,61,33,1.5185139398778875,11,22
48,61,41,1.6127838567197355,12,29
49,61,33,1.5185139398778875,14,19
50,61,34,1.5314789170422551,10,24
51,61,31,1.4913616938342726,13,18
52,61,35,1.5440680443502757,9,26
53,61,44,1.6434526764861874,16,28
54,61,35,1.5440680443502757,13,22
55,61,28,1.4471580313422192,11,17
56,61,32,1.505149978319906,12,20
57,61,21,1.3222192947339193,11,10
58,61,22,1.3424226808222062,11,11
59,61,20,1.3010299956639813,3,17
60,61,23,1.3617278360175928,7,16
61,61,21,1.3222192947339193,8,13
62,61,22,1.3424226808222062,8,14
63,61,18,1.255272505103306,5,13
64,61,23,1.3617278360175928,6,17
65,61,30,1.4771212547196624,14,16
66,61,12,1.0791812460476249,4,8
67,61,24,1.380211241711606,9,15
68,61,22,1.3424226808222062,8,14
69,61,22,1.3424226808222062,9,13
70,61,21,1.3222192947339193,10,11
71,61,19,1.2787536009528289,7,12
72,61,16,1.2041199826559248,6,10
73,61,17,1.2304489213782739,6,11
74,61,19,1.2787536009528289,11,8
75,61,7,0.8450980400142568,5,2
76,61,14,1.146128035678238,3,11
77,61,8,0.9030899869919435,2,6
78,61,11,1.0413926851582251,2,9
79,61,3,0.47712125471966244,1,2
80,61,4,0.6020599913279624,2,2
81,61,4,0.6020599913279624,3,1
82,61,2,0.3010299956639812,1,1
83,61,1,0.0,1,0
84,61,3,0.47712125471966244,1,2
85,61,2,0.3010299956639812,1,1
86,61,2,0.3010299956639812,0,2
11,62,1,0.0,0,1
14,62,1,0.0,1,0
15,62,2,0.3010299956639812,2,0
16,62,1,0.0,1,0
17,62,1,0.0,0,1
18,62,1,0.0,0,1
19,62,3,0.47712125471966244,1,2
20,62,5,0.6989700043360189,1,4
21,62,3,0.47712125471966244,2,1
22,62,10,1.0,3,7
23,62,7,0.8450980400142568,3,4
24,62,7,0.8450980400142568,5,2
25,62,6,0.7781512503836436,0,6
26,62,6,0.7781512503836436,1,5
27,62,7,0.8450980400142568,2,5
28,62,8,0.9030899869919435,4,4
29,62,16,1.2041199826559248,6,10
30,62,19,1.2787536009528289,7,12
31,62,15,1.1760912590556813,7,8
32,62,22,1.3424226808222062,8,14
33,62,14,1.146128035678238,5,9
34,62,21,1.3222192947339193,5,16
35,62,21,1.3222192947339193,4,17
36,62,22,1.3424226808222062,9,13
37,62,10,1.0,4,6
38,62,23,1.3617278360175928,4,19
39,62,16,1.2041199826559248,4,12
40,62,23,1.3617278360175928,11,12
41,62,11,1.0413926851582251,6,5
42,62,21,1.3222192947339193,6,15
43,62,35,1.5440680443502757,15,20
44,62,34,1.5314789170422551,12,22
45,62,21,1.3222192947339193,9,12
46,62,23,1.3617278360175928,8,15
47,62,38,1.5797835966168101,15,23
48,62,22,1.3424226808222062,8,14
49,62,34,1.5314789170422551,14,20
50,62,30,1.4771212547196624,11,19
51,62,33,1.5185139398778875,9,24
52,62,38,1.5797835966168101,16,22
53,62,31,1.4913616938342726,12,19
54,62,30,1.4771212547196624,7,23
55,62,27,1.4313637641589874,11,16
56,62,28,1.4471580313422192,12,16
57,62,17,1.2304489213782739,8,9
58,62,17,1.2304489213782739,6,11
59,62,25,1.3979400086720377,9,16
60,62,27,1.4313637641589874,7,20
61,62,29,1.462397997898956,4,25
62,62,22,1.3424226808222062,7,15
63,62,17,1.2304489213782739,5,12
64,62,24,1.380211241711606,6,18
65,62,18,1.255272505103306,4,14
66,62,17,1.2304489213782739,2,15
67,62,17,1.2304489213782739,4,13
68,62,11,1.0413926851582251,5,6
69,62,16,1.2041199826559248,6,10
70,62,9,0.9542425094393249,4,5
71,62,9,0.9542425094393249,3,6
72,62,7,0.8450980400142568,3,4
73,62,8,0.9030899869919435,1,7
74,62,6,0.7781512503836436,2,4
75,62,6,0.7781512503836436,1,5
76,62,7,0.8450980400142568,1,6
77,62,8,0.9030899869919435,2,6
78,62,4,0.6020599913279624,1,3
79,62,1,0.0,0,1
80,62,1,0.0,1,0
83,62,1,0.0,0,1
84,62,1,0.0,1,0
85,62,2,0.3010299956639812,1,1
87,62,2,0.3010299956639812,0,2
90,62,1,0.0,0,1
92,62,1,0.0,0,1
14,63,1,0.0,0,1
16,63,3,0.47712125471966244,0,3
17,63,3,0.47712125471966244,1,2
18,63,5,0.6989700043360189,2,3
19,63,2,0.3010299956639812,0,2
20,63,2,0.3010299956639812,2,0
21,63,1,0.0,1,0
22,63,3,0.47712125471966244,1,2
23,63,4,0.6020599913279624,0,4
24,63,5,0.6989700043360189,2,3
25,63,5,0.6989700043360189,0,5
26,63,4,0.6020599913279624,1,3
27,63,14,1.146128035678238,4,10
28,63,11,1.0413926851582251,4,7
29,63,13,1.1139433523068367,5,8
30,63,13,1.1139433523068367,3,10
31,63,13,1.1139433523068367,2,11
32,63,14,1.146128035678238,5,9
33,63,19,1.2787536009528289,9,10
34,63,17,1.2304489213782739,9,8
35,63,20,1.3010299956639813,5,15
36,63,19,1.2787536009528289,0,19
37,63,26,1.414973347970818,10,16
38,63,16,1.2041199826559248,7,9
39,63,25,1.3979400086720377,7,18
40,63,21,1.3222192947339193,9,12
41,63,27,1.4313637641589874,9,18
42,63,29,1.462397997898956,10,19
43,63,15,1.1760912590556813,5,10
44,63,27,1.4313637641589874,8,19
45,63,23,1.3617278360175928,8,15
46,63,20,1.3010299956639813,12,8
47,63,32,1.505149978319906,11,21
48,63,31,1.4913616938342726,9,22
49,63,30,1.4771212547196624,9,21
50,63,46,1.662757831681574,13,33
51,63,33,1.5185139398778875,11,22
52,63,32,1.505149978319906,8,24
53,63,30,1.4771212547196624,8,22
54,63,25,1.3979400086720377,7,18
55,63,35,1.5440680443502757,11,24
56,63,23,1.3617278360175928,8,15
57,63,28,1.4471580313422192,14,14
58,63,20,1.3010299956639813,4,16
59,63,28,1.4471580313422192,9,19
60,63,28,1.4471580313422192,9,19
61,63,31,1.4913616938342726,12,19
62,63,18,1.255272505103306,9,9
63,63,19,1.2787536009528289,6,13
64,63,21,1.3222192947339193,7,14
65,63,15,1.1760912590556813,5,10
66,63,12,1.0791812460476249,4,8
67,63,10,1.0,2,8
68,63,14,1.146128035678238,4,10
69,63,13,1.1139433523068367,3,10
70,63,7,0.8450980400142568,0,7
71,63,9,0.9542425094393249,3,6
72,63,7,0.8450980400142568,2,5
73,63,4,0.6020599913279624,1,3
74,63,1,0.0,1,0
75,63,7,0.8450980400142568,2,5
76,63,2,0.3010299956639812,1,1
77,63,3,0.47712125471966244,0,3
78,63,4,0.6020599913279624,0,4
79,63,3,0.47712125471966244,1,2
80,63,4,0.6020599913279624,1,3
81,63,3,0.47712125471966244,0,3
83,63,2,0.3010299956639812,0,2
84,63,2,0.3010299956639812,0,2
91,63,1,0.0,0,1
8,64,2,0.3010299956639812,0,2
15,64,1,0.0,0,1
16,64,1,0.0,1,0
17,64,1,0.0,1,0
18,64,1,0.0,0,1
19,64,1,0.0,0,1
20,64,2,0.3010299956639812,0,2
22,64,5,0.6989700043360189,2,3
23,64,5,0.6989700043360189,0,5
24,64,5,0.6989700043360189,2,3
25,64,4,0.6020599913279624,0,4
26,64,4,0.6020599913279624,2,2
27,64,8,0.9030899869919435,1,7
28,64,7,0.8450980400142568,1,6
29,64,6,0.7781512503836436,4,2
30,64,9,0.9542425094393249,2,7
31,64,11,1.0413926851582251,2,9
32,64,8,0.9030899869919435,2,6
33,64,11,1.0413926851582251,5,6
34,64,19,1.2787536009528289,7,12
35,64,21,1.3222192947339193,10,11
36,64,11,1.0413926851582251,5,6
37,64,16,1.2041199826559248,4,12
38,64,22,1.3424226808222062,10,12
39,64,16,1.2041199826559248,7,9
40,64,16,1.2041199826559248,5,11
41,64,22,1.3424226808222062,8,14
42,64,14,1.146128035678238,3,11
43,64,14,1.146128035678238,7,7
44,64,25,1.3979400086720377,8,17
45,64,20,1.3010299956639813,5,15
46,64,26,1.414973347970818,7,19
47,64,23,1.3617278360175928,10,13
48,64,33,1.5185139398778875,14,19
49,64,34,1.5314789170422551,15,19
50,64,30,1.4771212547196624,14,16
51,64,24,1.380211241711606,6,18
52,64,20,1.3010299956639813,3,17
53,64,28,1.4471580313422192,4,24
54,64,23,1.3617278360175928,6,17
55,64,20,1.3010299956639813,5,15
56,64,18,1.255272505103306,6,12
57,64,17,1.2304489213782739,6,11
58,64,15,1.1760912590556813,2,13
59,64,21,1.3222192947339193,3,18
60,64,15,1.1760912590556813,6,9
61,64,28,1.4471580313422192,7,21
62,64,17,1.2304489213782739,4,13
63,64,15,1.1760912590556813,2,13
64,64,14,1.146128035678238,3,11
65,64,13,1.1139433523068367,1,12
66,64,16,1.2041199826559248,4,12
67,64,14,1.146128035678238,8,6
68,64,10,1.0,5,5
69,64,6,0.7781512503836436,2,4
70,64,6,0.7781512503836436,2,4
71,64,9,0.9542425094393249,2,7
72,64,3,0.47712125471966244,1,2
73,64,8,0.9030899869919435,4,4
74,64,4,0.6020599913279624,1,3
75,64,3,0.47712125471966244,2,1
76,64,2,0.3010299956639812,0,2
77,64,5,0.6989700043360189,2,3
78,64,3,0.47712125471966244,0,3
79,64,1,0.0,1,0
81,64,1,0.0,0,1
82,64,1,0.0,0,1
89,64,1,0.0,0,1
12,65,1,0.0,0,1
15,65,1,0.0,0,1
19,65,3,0.47712125471966244,1,2
21,65,3,0.47712125471966244,1,2
22,65,2,0.3010299956639812,1,1
23,65,3,0.47712125471966244,1,2
24,65,6,0.7781512503836436,2,4
25,65,4,0.6020599913279624,1,3
26,65,3,0.47712125471966244,1,2
27,65,6,0.7781512503836436,3,3
28,65,9,0.9542425094393249,4,5
29,65,5,0.6989700043360189,1,4
30,65,3,0.47712125471966244,2,1
31,65,11,1.0413926851582251,2,9
32,65,8,0.9030899869919435,4,4
33,65,7,0.8450980400142568,1,6
34,65,16,1.2041199826559248,5,11
35,65,7,0.8450980400142568,1,6
36,65,17,1.2304489213782739,7,10
37,65,12,1.0791812460476249,3,9
38,65,7,0.8450980400142568,2,5
39,65,9,0.9542425094393249,1,8
40,65,11,1.0413926851582251,3,8
41,65,10,1.0,1,9
42,65,26,1.414973347970818,10,16
43,65,17,1.2304489213782739,5,12
44,65,24,1.380211241711606,8,16
45,65,18,1.255272505103306,5,13
46,65,18,1.255272505103306,7,11
47,65,19,1.2787536009528289,5,14
48,65,21,1.3222192947339193,9,12
49,65,41,1.6127838567197355,11,30
50,65,21,1.3222192947339193,5,16
51,65,28,1.4471580313422192,9,19
52,65,26,1.414973347970818,12,14
53,65,19,1.2787536009528289,6,13
54,65,19,1.2787536009528289,4,15
55,65,19,1.2787536009528289,8,11
56,65,21,1.3222192947339193,4,17
57,65,18,1.255272505103306,8,10
58,65,19,1.2787536009528289,11,8
59,65,19,1.2787536009528289,7,12
60,65,15,1.1760912590556813,3,12
61,65,13,1.1139433523068367,2,11
62,65,9,0.9542425094393249,3,6
63,65,8,0.9030899869919435,3,5
64,65,7,0.8450980400142568,1,6
65,65,11,1.0413926851582251,3,8
66,65,8,0.9030899869919435,2,6
67,65,4,0.6020599913279624,2,2
68,65,6,0.7781512503836436,2,4
69,65,6,0.7781512503836436,3,3
70,65,8,0.9030899869919435,0,8
71,65,3,0.47712125471966244,1,2
72,65,7,0.8450980400142568,3,4
73,65,4,0.6020599913279624,2,2
74,65,4,0.6020599913279624,2,2
75,65,4,0.6020599913279624,2,2
76,65,2,0.3010299956639812,0,2
77,65,3,0.47712125471966244,0,3
78,65,3,0.47712125471966244,1,2
81,65,1,0.0,1,0
92,65,1,0.0,0,1
13,66,1,0.0,0,1
17,66,1,0.0,1,0
19,66,1,0.0,0,1
21,66,1,0.0,1,0
22,66,2,0.3010299956639812,0,2
23,66,1,0.0,0,1
24,66,3,0.47712125471966244,0,3
25,66,1,0.0,0,1
26,66,5,0.6989700043360189,1,4
28,66,2,0.3010299956639812,0,2
29,66,7,0.8450980400142568,3,4
30,66,1,0.0,0,1
31,66,6,0.7781512503836436,1,5
32,66,6,0.7781512503836436,3,3
33,66,10,1.0,2,8
34,66,9,0.9542425094393249,3,6
35,66,14,1.146128035678238,4,10
36,66,6,0.7781512503836436,3,3
37,66,5,0.6989700043360189,2,3
38,66,9,0.9542425094393249,1,8
39,66,13,1.1139433523068367,6,7
40,66,9,0.9542425094393249,5,4
41,66,14,1.146128035678238,4,10
42,66,8,0.9030899869919435,1,7
43,66,13,1.1139433523068367,3,10
44,66,12,1.0791812460476249,5,7
45,66,19,1.2787536009528289,6,13
46,66,20,1.3010299956639813,4,16
47,66,14,1.146128035678238,10,4
48,66,15,1.1760912590556813,7,8
49,66,21,1.3222192947339193,9,12
50,66,23,1.3617278360175928,6,17
51,66,12,1.0791812460476249,5,7
52,66,26,1.414973347970818,6,20
53,66,16,1.2041199826559248,5,11
54,66,11,1.0413926851582251,3,8
55,66,13,1.1139433523068367,5,8
56,66,10,1.0,4,6
57,66,12,1.0791812460476249,5,7
58,66,12,1.0791812460476249,6,6
59,66,21,1.3222192947339193,6,15
60,66,5,0.6989700043360189,1,4
61,66,7,0.8450980400142568,4,3
62,66,7,0.8450980400142568,3,4
63,66,10,1.0,3,7
64,66,8,0.9030899869919435,6,2
65,66,8,0.9030899869919435,4,4
66,66,7,0.8450980400142568,1,6
67,66,7,0.8450980400142568,2,5
68,66,7,0.8450980400142568,2,5
69,66,4,0.6020599913279624,2,2
70,66,3,0.47712125471966244,2,1
71,66,2,0.3010299956639812,1,1
72,66,4,0.6020599913279624,1,3
73,66,1,0.0,0,1
74,66,2,0.3010299956639812,0,2
75,66,2,0.3010299956639812,1,1
76,66,2,0.3010299956639812,0,2
77,66,3,0.47712125471966244,0,3
79,66,1,0.0,1,0
80,66,2,0.3010299956639812,1,1
82,66,2,0.3010299956639812,0,2
86,66,1,0.0,0,1
12,67,1,0.0,0,1
14,67,2,0.3010299956639812,1,1
22,67,1,0.0,0,1
23,67,2,0.3010299956639812,0,2
24,67,2,0.3010299956639812,1,1
25,67,1,0.0,1,0
26,67,3,0.47712125471966244,0,3
27,67,1,0.0,0,1
28,67,6,0.7781512503836436,2,4
29,67,1,0.0,1,0
30,67,1,0.0,0,1
31,67,4,0.6020599913279624,1,3
32,67,3,0.47712125471966244,2,1
33,67,6,0.7781512503836436,1,5
34,67,3,0.47712125471966244,1,2
35,67,6,0.7781512503836436,3,3
36,67,7,0.8450980400142568,2,5
37,67,5,0.6989700043360189,0,5
38,67,5,0.6989700043360189,0,5
39,67,7,0.8450980400142568,0,7
40,67,10,1.0,5,5
41,67,11,1.0413926851582251,2,9
42,67,14,1.146128035678238,6,8
43,67,5,0.6989700043360189,1,4
44,67,10,1.0,3,7
45,67,11,1.0413926851582251,1,10
46,67,14,1.146128035678238,4,10
47,67,13,1.1139433523068367,6,7
48,67,16,1.2041199826559248,6,10
49,67,8,0.9030899869919435,4,4
50,67,11,1.0413926851582251,7,4
51,67,19,1.2787536009528289,5,14
52,67,16,1.2041199826559248,8,8
53,67,14,1.146128035678238,3,11
54,67,3,0.47712125471966244,0,3
55,67,8,0.9030899869919435,4,4
56,67,11,1.0413926851582251,8,3
57,67,6,0.7781512503836436,1,5
58,67,8,0.9030899869919435,5,3
59,67,5,0.6989700043360189,1,4
60,67,4,0.6020599913279624,2,2
61,67,16,1.2041199826559248,4,12
62,67,12,1.0791812460476249,4,8
63,67,9,0.9542425094393249,0,9
64,67,8,0.9030899869919435,3,5
65,67,3,0.47712125471966244,1,2
66,67,11,1.0413926851582251,3,8
67,67,5,0.6989700043360189,3,2
68,67,5,0.6989700043360189,1,4
69,67,4,0.6020599913279624,2,2
70,67,1,0.0,0,1
71,67,1,0.0,0,1
72,67,5,0.6989700043360189,2,3
73,67,1,0.0,0,1
74,67,2,0.3010299956639812,1,1
75,67,1,0.0,1,0
76,67,1,0.0,1,0
78,67,1,0.0,0,1
79,67,1,0.0,1,0
9,68,1,0.0,0,1
13,68,1,0.0,0,1
20,68,2,0.3010299956639812,0,2
21,68,1,0.0,0,1
22,68,1,0.0,0,1
24,68,1,0.0,1,0
25,68,1,0.0,0,1
26,68,2,0.3010299956639812,0,2
27,68,2,0.3010299956639812,1,1
28,68,1,0.0,0,1
29,68,4,0.6020599913279624,2,2
30,68,2,0.3010299956639812,1,1
31,68,2,0.3010299956639812,0,2
32,68,5,0.6989700043360189,1,4
33,68,2,0.3010299956639812,0,2
34,68,4,0.6020599913279624,3,1
35,68,6,0.7781512503836436,2,4
36,68,4,0.6020599913279624,3,1
37,68,8,0.9030899869919435,2,6
38,68,5,0.6989700043360189,0,5
39,68,6,0.7781512503836436,4,2
40,68,9,0.9542425094393249,3,6
41,68,8,0.9030899869919435,1,7
42,68,8,0.9030899869919435,0,8
43,68,6,0.7781512503836436,1,5
44,68,6,0.7781512503836436,0,6
45,68,8,0.9030899869919435,0,8
46,68,6,0.7781512503836436,1,5
47,68,13,1.1139433523068367,8,5
48,68,12,1.0791812460476249,4,8
49,68,13,1.1139433523068367,5,8
50,68,12,1.0791812460476249,4,8
51,68,12,1.0791812460476249,4,8
52,68,9,0.9542425094393249,1,8
53,68,5,0.6989700043360189,2,3
54,68,8,0.9030899869919435,1,7
55,68,5,0.6989700043360189,2,3
56,68,9,0.9542425094393249,1,8
57,68,3,0.47712125471966244,2,1
58,68,6,0.7781512503836436,1,5
59,68,9,0.9542425094393249,7,2
60,68,7,0.8450980400142568,1,6
61,68,7,0.8450980400142568,4,3
62,68,2,0.3010299956639812,0,2
63,68,6,0.7781512503836436,2,4
64,68,2,0.3010299956639812,1,1
65,68,1,0.0,0,1
66,68,6,0.7781512503836436,3,3
67,68,3,0.47712125471966244,2,1
69,68,5,0.6989700043360189,3,2
70,68,1,0.0,1,0
71,68,3,0.47712125471966244,3,0
72,68,2,0.3010299956639812,0,2
73,68,1,0.0,0,1
74,68,1,0.0,0,1
75,68,2,0.3010299956639812,1,1
76,68,2,0.3010299956639812,1,1
77,68,1,0.0,0,1
78,68,1,0.0,0,1
79,68,2,0.3010299956639812,2,0
82,68,1,0.0,1,0
17,69,1,0.0,0,1
18,69,1,0.0,0,1
22,69,2,0.3010299956639812,1,1
24,69,1,0.0,0,1
25,69,1,0.0,0,1
26,69,3,0.47712125471966244,1,2
27,69,1,0.0,0,1
30,69,1,0.0,0,1
31,69,2,0.3010299956639812,1,1
32,69,1,0.0,1,0
33,69,3,0.47712125471966244,1,2
34,69,2,0.3010299956639812,0,2
35,69,1,0.0,1,0
36,69,6,0.7781512503836436,3,3
37,69,1,0.0,0,1
38,69,3,0.47712125471966244,1,2
39,69,4,0.6020599913279624,3,1
40,69,5,0.6989700043360189,2,3
41,69,6,0.7781512503836436,1,5
42,69,4,0.6020599913279624,1,3
43,69,3,0.47712125471966244,1,2
44,69,6,0.7781512503836436,2,4
45,69,3,0.47712125471966244,0,3
46,69,3,0.47712125471966244,0,3
47,69,4,0.6020599913279624,0,4
48,69,7,0.8450980400142568,4,3
49,69,10,1.0,1,9
50,69,9,0.9542425094393249,0,9
51,69,9,0.9542425094393249,2,7
52,69,7,0.8450980400142568,3,4
53,69,9,0.9542425094393249,2,7
54,69,2,0.3010299956639812,0,2
55,69,2,0.3010299956639812,1,1
56,69,6,0.7781512503836436,3,3
57,69,6,0.7781512503836436,2,4
58,69,4,0.6020599913279624,2,2
59,69,5,0.6989700043360189,2,3
60,69,2,0.3010299956639812,1,1
61,69,2,0.3010299956639812,0,2
62,69,3,0.47712125471966244,3,0
63,69,1,0.0,0,1
64,69,2,0.3010299956639812,0,2
65,69,3,0.47712125471966244,2,1
66,69,3,0.47712125471966244,1,2
67,69,3,0.47712125471966244,1,2
68,69,1,0.0,1,0
69,69,3,0.47712125471966244,2,1
70,69,4,0.6020599913279624,1,3
71,69,2,0.3010299956639812,0,2
72,69,2,0.3010299956639812,0,2
73,69,2,0.3010299956639812,2,0
76,69,1,0.0,0,1
77,69,1,0.0,0,1
86,69,1,0.0,0,1
18,70,1,0.0,0,1
20,70,1,0.0,0,1
21,70,2,0.3010299956639812,1,1
23,70,3,0.47712125471966244,0,3
25,70,1,0.0,0,1
27,70,1,0.0,0,1
29,70,1,0.0,1,0
32,70,1,0.0,0,1
33,70,1,0.0,0,1
34,70,2,0.3010299956639812,1,1
35,70,3,0.47712125471966244,1,2
36,70,5,0.6989700043360189,1,4
37,70,4,0.6020599913279624,1,3
38,70,5,0.6989700043360189,1,4
39,70,4,0.6020599913279624,2,2
40,70,2,0.3010299956639812,1,1
41,70,5,0.6989700043360189,2,3
42,70,4,0.6020599913279624,1,3
43,70,4,0.6020599913279624,1,3
44,70,4,0.6020599913279624,1,3
45,70,3,0.47712125471966244,1,2
46,70,3,0.47712125471966244,3,0
47,70,6,0.7781512503836436,2,4
48,70,2,0.3010299956639812,1,1
49,70,6,0.7781512503836436,3,3
50,70,4,0.6020599913279624,1,3
51,70,13,1.1139433523068367,3,10
52,70,7,0.8450980400142568,3,4
53,70,3,0.47712125471966244,2,1
54,70,6,0.7781512503836436,2,4
55,70,6,0.7781512503836436,0,6
56,70,3,0.47712125471966244,0,3
57,70,10,1.0,2,8
58,70,4,0.6020599913279624,0,4
59,70,2,0.3010299956639812,1,1
61,70,2,0.3010299956639812,2,0
62,70,7,0.8450980400142568,1,6
63,70,2,0.3010299956639812,1,1
64,70,2,0.3010299956639812,0,2
65,70,1,0.0,1,0
66,70,2,0.3010299956639812,1,1
67,70,1,0.0,1,0
68,70,2,0.3010299956639812,1,1
69,70,1,0.0,0,1
70,70,2,0.3010299956639812,0,2
71,70,3,0.47712125471966244,2,1
72,70,1,0.0,1,0
74,70,3,0.47712125471966244,0,3
78,70,1,0.0,0,1
84,70,1,0.0,0,1
85,70,1,0.0,0,1
86,70,1,0.0,0,1
14,71,1,0.0,0,1
20,71,1,0.0,0,1
26,71,2,0.3010299956639812,0,2
30,71,1,0.0,0,1
32,71,1,0.0,0,1
33,71,2,0.3010299956639812,1,1
34,71,2,0.3010299956639812,1,1
36,71,4,0.6020599913279624,2,2
37,71,1,0.0,1,0
38,71,1,0.0,0,1
39,71,2,0.3010299956639812,1,1
40,71,4,0.6020599913279624,2,2
41,71,1,0.0,0,1
42,71,5,0.6989700043360189,1,4
43,71,5,0.6989700043360189,0,5
44,71,4,0.6020599913279624,0,4
45,71,3,0.47712125471966244,2,1
46,71,2,0.3010299956639812,0,2
47,71,1,0.0,1,0
48,71,2,0.3010299956639812,0,2
49,71,2,0.3010299956639812,1,1
50,71,3,0.47712125471966244,0,3
51,71,2,0.3010299956639812,0,2
52,71,1,0.0,0,1
53,71,4,0.6020599913279624,1,3
55,71,1,0.0,0,1
56,71,2,0.3010299956639812,1,1
57,71,2,0.3010299956639812,1,1
58,71,3,0.47712125471966244,1,2
59,71,1,0.0,0,1
60,71,3,0.47712125471966244,3,0
61,71,3,0.47712125471966244,0,3
62,71,1,0.0,0,1
63,71,2,0.3010299956639812,0,2
64,71,1,0.0,0,1
75,71,1,0.0,1,0
78,71,1,0.0,1,0
13,72,2,0.3010299956639812,0,2
19,72,1,0.0,0,1
25,72,1,0.0,0,1
28,72,1,0.0,0,1
32,72,3,0.47712125471966244,3,0
35,72,2,0.3010299956639812,0,2
36,72,1,0.0,0,1
38,72,1,0.0,0,1
39,72,2,0.3010299956639812,2,0
40,72,1,0.0,0,1
41,72,1,0.0,0,1
42,72,3,0.47712125471966244,2,1
43,72,1,0.0,1,0
44,72,1,0.0,0,1
45,72,3,0.47712125471966244,0,3
46,72,4,0.6020599913279624,1,3
47,72,2,0.3010299956639812,2,0
48,72,1,0.0,0,1
50,72,5,0.6989700043360189,1,4
51,72,4,0.6020599913279624,1,3
52,72,2,0.3010299956639812,1,1
53,72,4,0.6020599913279624,2,2
54,72,2,0.3010299956639812,1,1
55,72,3,0.47712125471966244,0,3
56,72,1,0.0,0,1
57,72,2,0.3010299956639812,1,1
61,72,2,0.3010299956639812,1,1
63,72,2,0.3010299956639812,1,1
64,72,1,0.0,1,0
65,72,1,0.0,0,1
67,72,1,0.0,0,1
71,72,1,0.0,0,1
77,72,1,0.0,0,1
80,72,1,0.0,0,1
83,72,1,0.0,0,1
87,72,1,0.0,0,1
91,72,1,0.0,1,0
11,73,1,0.0,0,1
27,73,1,0.0,1,0
33,73,1,0.0,1,0
35,73,2,0.3010299956639812,0,2
36,73,2,0.3010299956639812,0,2
37,73,1,0.0,1,0
40,73,1,0.0,0,1
43,73,1,0.0,0,1
44,73,1,0.0,0,1
46,73,4,0.6020599913279624,2,2
47,73,1,0.0,1,0
48,73,2,0.3010299956639812,1,1
49,73,3,0.47712125471966244,1,2
50,73,2,0.3010299956639812,2,0
51,73,2,0.3010299956639812,1,1
52,73,3,0.47712125471966244,1,2
54,73,2,0.3010299956639812,0,2
56,73,1,0.0,0,1
57,73,1,0.0,0,1
58,73,1,0.0,0,1
60,73,3,0.47712125471966244,1,2
63,73,1,0.0,0,1
67,73,1,0.0,0,1
68,73,1,0.0,0,1
70,73,2,0.3010299956639812,1,1
76,73,1,0.0,0,1
30,74,1,0.0,1,0
34,74,1,0.0,0,1
37,74,1,0.0,0,1
42,74,2,0.3010299956639812,0,2
43,74,1,0.0,0,1
45,74,1,0.0,0,1
48,74,2,0.3010299956639812,1,1
49,74,1,0.0,0,1
50,74,1,0.0,0,1
52,74,1,0.0,0,1
53,74,1,0.0,0,1
55,74,2,0.3010299956639812,0,2
56,74,1,0.0,0,1
57,74,1,0.0,0,1
58,74,1,0.0,0,1
59,74,1,0.0,0,1
60,74,1,0.0,0,1
63,74,2,0.3010299956639812,1,1
64,74,2,0.3010299956639812,1,1
65,74,1,0.0,0,1
67,74,1,0.0,1,0
78,74,1,0.0,0,1
87,74,1,0.0,0,1
13,75,1,0.0,0,1
33,75,1,0.0,0,1
35,75,1,0.0,0,1
37,75,1,0.0,0,1
39,75,1,0.0,0,1
42,75,1,0.0,0,1
44,75,1,0.0,1,0
49,75,1,0.0,1,0
50,75,1,0.0,0,1
51,75,2,0.3010299956639812,1,1
52,75,1,0.0,0,1
53,75,1,0.0,1,0
54,75,1,0.0,1,0
57,75,1,0.0,0,1
61,75,1,0.0,0,1
63,75,1,0.0,0,1
65,75,1,0.0,0,1
69,75,1,0.0,1,0
79,75,1,0.0,0,1
15,76,1,0.0,0,1
34,76,1,0.0,1,0
35,76,1,0.0,0,1
40,76,1,0.0,0,1
42,76,1,0.0,1,0
46,76,1,0.0,0,1
47,76,1,0.0,0,1
49,76,1,0.0,1,0
50,76,2,0.3010299956639812,1,1
51,76,1,0.0,0,1
54,76,2,0.3010299956639812,0,2
58,76,1,0.0,0,1
61,76,1,0.0,1,0
64,76,1,0.0,0,1
65,76,2,0.3010299956639812,2,0
74,76,1,0.0,0,1
18,77,1,0.0,0,1
31,77,1,0.0,0,1
44,77,1,0.0,0,1
46,77,1,0.0,0,1
48,77,1,0.0,0,1
49,77,1,0.0,0,1
60,77,1,0.0,1,0
61,77,1,0.0,0,1
71,77,1,0.0,0,1
87,77,1,0.0,0,1
23,78,1,0.0,0,1
32,78,1,0.0,0,1
35,78,1,0.0,1,0
46,78,1,0.0,0,1
47,78,1,0.0,1,0
49,78,1,0.0,0,1
50,78,1,0.0,0,1
55,78,1,0.0,1,0
78,78,1,0.0,0,1
30,79,1,0.0,0,1
31,79,1,0.0,0,1
48,79,1,0.0,0,1
49,79,1,0.0,0,1
53,79,1,0.0,1,0
60,79,1,0.0,1,0
6,80,1,0.0,0,1
44,80,1,0.0,0,1
51,80,1,0.0,0,1
54,80,1,0.0,0,1
84,80,1,0.0,0,1
91,80,1,0.0,0,1
18,81,1,0.0,0,1
28,81,1,0.0,0,1
80,81,1,0.0,0,1
40,82,1,0.0,0,1
42,82,1,0.0,0,1
49,82,1,0.0,1,0
82,82,1,0.0,0,1
37,83,1,0.0,0,1
62,83,1,0.0,0,1
84,83,1,0.0,0,1
19,84,1,0.0,0,1
30,84,1,0.0,0,1
92,84,1,0.0,0,1
17,85,1,0.0,0,1
18,85,1,0.0,0,1
35,85,1,0.0,0,1
56,86,1,0.0,1,0
85,86,1,0.0,0,1
89,86,1,0.0,1,0
90,86,1,0.0,1,0
23,87,1,0.0,0,1
7,88,1,0.0,0,1
26,88,1,0.0,0,1
34,88,1,0.0,1,0
48,88,1,0.0,0,1
79,88,1,0.0,1,0
95,88,1,0.0,0,1
18,89,1,0.0,0,1
43,89,1,0.0,0,1
50,89,1,0.0,0,1
59,89,1,0.0,0,1
74,90,1,0.0,0,1
85,90,1,0.0,1,0
86,90,1,0.0,1,0
26,91,1,0.0,0,1
30,91,1,0.0,1,0
90,91,1,0.0,0,1
45,92,1,0.0,0,1
54,92,1,0.0,0,1
79,92,1,0.0,0,1
48,93,1,0.0,0,1
70,93,1,0.0,1,0
74,93,1,0.0,0,1
83,93,1,0.0,0,1
27,94,1,0.0,1,0
65,98,1,0.0,0,1
